去	q
起	q[
前	q]
我	w
为	w[
无	w]
他	t
她	t[
天	t]
一	y
有	y[
也	y]
是	s
说	s[
上	s]
人	r
然	r[
而	r]
的	d
得	d[
地	d]
在	f
自	f[
发	f]
个	g
过	g[
更	g]
会	h[
好	h
还	h]
将	j[
就	j
间	j]
可	k
看	k[
空	k]
了	l
来	l]
里	l[
下	x
心	x[
小	x]
成	c[
出	c
从	c]
这	v
中	v[
只	v]
不	b
把	b[
被	b]
你	n
能	n[
那	n]
没	m
吗	m[
明	m]
到	p
大	p[
都	p]
着	ve
们	mw
道	db
么	me
子	fk
时	sk
要	yb
后	h/
以	yk
和	hd
对	dx
想	x;
之	vi
手	sl
生	st
使	sku
身	sw
头	tl
样	yp
事	sm
多	do
己	jk
家	jq
面	mc
知	viu
开	kq
如	rj
现	xc
很	hs
点	df
经	jt
情	qg
老	lh
些	xe
话	hq
已	yka
又	y/
声	stz
意	ym
于	yj
回	hd/
笑	xb
所	slu
但	dc
眼	yf
方	fp
年	nf
见	jc
当	dp
女	nj
真	vw
两	l;
力	lm
气	qm
用	y//
长	c;
长	v;
动	d/
国	gl
走	fl
让	rp
给	gd
正	vv
问	wz
打	da
儿	rk
法	fa
才	ca
几	jk/
行	h;
行	xg
三	sr
定	dv
此	ck
进	jz
再	fq
种	vl
实	sk;
同	tl/
最	fx
本	bs
向	xp
分	fw
十	skz
学	xd
高	gy
第	dm
感	gf
怎	fs
神	ss
听	tt
边	br
作	f/
其	qk
吧	bq
却	qx
口	kl
觉	jd
啊	rq
因	yw
白	ba
次	cm
军	jw
做	f/u
外	wq
门	ms
光	gp
风	ft
主	vj
住	vn
果	gl/
与	yjz
全	qf
二	rm
候	h/u
公	go
相	xpe
相	xpei
等	dg
别	bd
色	sx
死	skzu
张	vp
部	bn
太	tq
日	rm/
少	sh
少	sb
战	vc
理	lk
直	vk
重	cl
重	v/
王	w;
像	xpu
脸	lf
比	bk
快	kqo
何	hdu
水	sd
名	mg
体	tk
呢	ne
东	doz
叫	jb
西	xi
应	yt
应	yv
便	bc
便	pf
放	fpo
马	ma
难	nfa
轻	qt
美	md
位	wx
关	gr
机	ji
接	je
先	xr
文	ws
处	cj
处	cn
并	bv
望	wp
常	c;/
完	wf
四	sm/
飞	fe
师	si
者	vd
安	rr
清	qto
刚	gpi
跟	gw
月	yx
信	xz
山	sr/
爱	rq/
内	nx
龙	ll
带	dq
找	vh
原	yfz
入	rn
李	lkz
连	lfz
吃	ci
场	c;e
平	pg
思	si/
林	ls
变	bc;
什	ssu
由	yl
受	s/
亲	qw
命	mv
目	mn
强	q;
男	nf/
任	rz
该	gq
路	ln
车	ce
今	jw/
海	ha
加	jqa
远	yfze
活	hl
特	tx
解	jdu
电	dc/
世	smz
性	xv
表	bh
许	xj
它	tq;
立	lm;
黑	he
金	jw/o
红	hla
花	hqz
转	vf
转	vce
总	fl;
算	sc
城	cg
队	dxa
孩	haa
反	ff
工	goz
始	ska
满	mf
新	xw
兵	bt
物	wn
离	lk;
非	fei
虽	se
云	ys
似	smu
万	wc
至	vm
干	grz
干	gc
通	to
认	rzo
失	si/e
火	hl;
哥	ge
士	smzi
五	wj
惊	jto
魔	ml
竟	jv
姐	jda
乎	hu
剑	jcu
往	w;u
量	l;/
量	lp
早	fh
结	jdaa
着	vy
着	vh;
着	vl;
怕	pq
流	llo
突	tu
坐	f//
斯	sie
音	yw;
紧	js
指	vke
拉	lq
杀	sq
半	bc;u
记	jm
且	qd
利	lmu
合	hd/o
倒	dh
倒	dbu
书	su
度	dn
微	we
步	bn/
教	jy
教	jbe
喜	xk
越	yxz
影	yg
谁	sdo
冷	lg
深	swo
告	gb
落	l/
象	xp/
容	rl
怪	gqo
传	cf
传	vcu
钱	qfu
提	tke
言	yf;
随	sda
每	md/
双	sp
服	fj
击	jiz
武	wjz
哪	na
数	sj
数	sn
站	vco
奇	qkz
房	f;
管	gf/
灵	lga
刻	kx
题	tk/
衣	yi
周	vo
静	jve
伤	spu
百	baz
拿	na/
妈	mq
办	bca
星	xt
化	hqu
功	goe
绝	jdaa
系	xm
般	bru
必	bm
业	yx/
尔	rk/
件	jcui
血	xd/
血	xx
代	dqu
精	jtou
弟	dm;
终	voa
近	jz/
条	th
青	qtz
界	jx
司	sia
整	vg
欢	hr
字	fm
晚	wfi
民	msa
帮	bp
切	qe
切	qxe
即	jka
忙	m;
交	jy;
或	h/z
暗	rc
夫	fu
员	yf/
根	gwe
石	skzu
哈	hqi
夜	yx;
父	fn
制	vmu
友	ylz
阿	rqa
息	xi/
冲	co
酒	jl
保	bhu
片	pc
形	xge
阵	vz
南	nfz
决	jdo
请	qgo
各	gx
报	bb
兴	xt;
兴	xv;
阳	y;
急	jk/a
语	yjo
令	lv
错	c/
及	jkau
刘	lloe
极	jke
识	sko
备	bx
慢	mco
雪	xdz
苦	kj
若	r/
领	lgu
收	so
底	dk
尽	jza
准	vs
华	ha/
华	hq/
答	da/
众	v//
千	qr
要	yy
消	xy
视	smo
罗	ll/
敢	gfa
留	ll/a
克	kxz
乐	lx
乐	yx/a
够	g/
跑	ph
显	xf
嘴	fd
官	gr;
断	dco
未	wxz
势	smzi
句	jn
求	ql
计	jmo
论	lz
达	daz
则	fdi
害	hq;
八	bq/
单	dr
久	jl/
脚	jh
德	dd
元	yfze
脑	nh
楚	cjz
雨	yjzi
睛	jti
响	x;i
刀	dy
确	qxeu
玉	yn
沉	cs
北	bdi
格	gde
停	tg
陈	csa
市	sm;
朝	vye
朝	ch
喝	hei
族	fjo
江	jp
团	tf
母	mj
章	vp;
装	vp;e
亮	lp;
客	kx;
照	vb
乱	lc
易	ym/
足	fj/
依	yiu
黄	h;z
修	xo
破	p/
台	ta
球	qle
呀	yq
院	yc
送	s/;
包	by
义	ym;
诉	sno
攻	goei
丝	siaa
围	wd
玩	wfe
待	dquu
待	dquu
复	fn/
况	kp
楼	lle
丽	lmz
痛	t/
梦	mvz
呼	hui
摇	yh
期	qke
英	ytz
低	di
帝	dm;e
兄	xo/
背	be
背	bx/
持	cke
爷	yd
皇	h;/
七	qi
六	l/;
穿	cr
杨	y;e
政	vve
运	yz
居	ju
叶	yxi
热	rx
校	jbei
校	xbe
谢	xxo
曾	cg;
古	gj
细	xma
产	cf;
睡	sxi
希	xi/o
速	snz
室	sm;o
旁	p;
另	lv/
怀	hao
露	lnz
异	yma
写	xd;
鬼	gd/
娘	n;
取	qj
式	smza
除	cja
级	jkaa
考	kh
建	jca
愿	ycz
招	vyei
饭	fc
布	bnz
续	xn
程	cgu
首	sl;
观	gra
朋	pgu
务	wn/
掉	dbe
赶	gfz
忽	hu/
注	vno
术	snzi
甚	sz
差	cq
呵	heia
展	vfa
争	vt
品	ps
兰	lf;
宝	bh;
香	xp/e
斗	d/;
故	gn
雷	ld
念	nc
段	dcu
顿	dz
角	jh/
角	jd/
疑	yku
护	hn
闪	sf
木	mnz
需	xu
调	dbo
调	tho
类	lx;
妹	mx
爸	bq/o
线	xca
左	flz
游	ylo
派	pqo
谈	tfo
激	jio
冰	bto
敌	dku
跳	tb
支	viz
约	ye
巴	bqa
您	ns
顾	gne
肯	ks
醒	xgei
铁	td
抱	bbe
淡	dcoo
造	fb
伙	hlu
资	fi
群	qs
集	jk/i
联	lfe
商	sp;
号	hh
号	hb
节	jdz
讲	j;
掌	v;/
赵	vbz
密	mm
九	jl/a
病	bv;
卫	wxa
米	mk
威	wez
继	jma
渐	jco
统	tla
追	ve/
亚	yqz
简	jf
练	lca
基	jizi
选	xf/
推	te
改	ga
退	txa
味	wxi
份	fz
举	jj
示	smze
忍	rs
历	lmzu
器	qm/
恐	klz
引	ysa
试	smoa
皮	pk
习	xka
靠	kb
导	dha
存	csz
莫	m/
志	vmz
区	qu
汉	hc
右	y/z
严	yfzi
态	tqz
买	maa
幸	xvz
社	sxo
佛	flu
佛	fju
议	ymo
树	sne
止	vk/
块	kqe
守	sl;o
毛	mh
挥	hee
胡	hj
散	sfe
散	sce
板	bf
仅	jsu
隐	ysai
怒	nn
床	c;;
苏	suz
料	lb
股	gju
局	jja
班	bre
图	tj
岁	sx/
礼	lko
独	dj
初	cu
福	fjoa
顺	szu
狂	k;
默	m/i
巨	jnz
既	jmae
松	soe
证	vvo
烈	lxz
否	flzu
恶	rd
恶	rxz
恶	wnz
治	vmo
缓	hf
排	pa
费	fxa
拍	pqe
耳	rkz
医	yiz
寒	hf;
哭	ku
温	ww
府	fj;
担	dre
担	dce
称	cz
称	ct
称	cv
余	yj/
钟	vou
泪	lxo
烟	yr
仍	rg
具	jn/
忘	wp;
恩	rw
毕	bmz
警	jg
蓝	lfzi
宫	go;
吸	xii
陆	lna
究	jo
抓	vq
压	yqzu
沙	sqo
救	j/
呆	dq/
河	hdo
迷	mk;
枪	qp
组	fja
权	qfe
叹	tc
孙	swa
卷	jf;
查	caz
毫	hh;
春	cw
察	ca;
圣	sv
草	chz
较	jbea
胜	svu
遇	yn/
充	co;
史	sk/
堂	t;
防	f;a
据	jne
猛	mgu
骑	qka
土	tjz
卡	ka
助	vni
京	jt;
银	ysu
贵	gx/
永	yl;
质	vm/
屋	wu
须	xuu
副	fne
换	hce
刺	cme
属	sja
闻	ws;
境	jvei
禁	jwz
禁	jzz
阴	ywa
共	g/z
负	fn/a
弄	n/
翻	fr
虎	hj/
层	cga
喊	hfi
逃	th/
晓	xh
座	f/;
雅	ya
参	cra
射	sxu
婚	hw
险	xfa
君	jwa
划	hqe
坚	jr
价	jqu
柔	rla
超	cy
扬	y;ei
科	ke
按	rce
狠	hsu
野	ydi
秦	qsz
秘	mmu
熟	sl;e
熟	sj;
置	vm/a
仙	xru
模	mle
模	mje
伸	swu
波	bo
肉	r//
假	ja
假	jqui
齐	qk;
舞	wj/
脱	tou
广	g;
姑	gu
麻	ma;
投	tle
顶	dge
致	vme
责	fdz
景	jg/
营	ygz
维	wda
设	sxoa
坏	hqei
啦	lqi
秀	x/
败	bqi
眉	mda
州	vo;
药	ybz
承	cgai
案	rc;
狼	l;u
专	vr
偷	toui
画	hqzi
吴	wj/a
店	dc;
哦	r/i
弹	dca
弹	tfa
食	sk/o
欲	ynu
抬	tae
标	bye
秋	qo
厉	lmzu
良	l;;
际	jmai
状	vpo
烦	ffo
午	wj/e
摆	bae
戏	xmao
桌	vo/
船	cfu
短	dfu
村	cwe
某	mlz
摸	mo
付	fnu
演	yfo
规	gee
萧	xyz
封	fte
握	w/
田	tf/
唐	t;;
藏	c;z
震	vzz
混	hso
混	hz
虚	xu/
透	t//
纪	jmaa
凌	lgo
休	xou
嘛	mqi
梅	mde
紫	fk/
歌	geei
临	lsi
毒	djz
宗	fo
著	vnz
索	slz
印	yzu
寻	xs
湖	hjo
劲	jzao
职	vkei
技	jme
恨	hzo
婆	pl
杰	jdzi
羽	yja
咱	ffi
素	snze
凡	ff/
值	vku
飘	py
养	y;;
嘿	heia
普	pj
宁	ng
宁	nv
吓	xq
兽	s/;u
夏	xqz
读	djo
街	jeu
牛	nl
仿	f;u
胸	xoua
浪	lpo
富	fn;
尚	sp/
宇	yj;
骨	gj/
智	vm/e
纷	fwa
升	st/
叔	sui
善	sc;
弱	r/a
架	jqau
卖	mqz
袋	dq/i
网	w;/
朱	vu
骂	mq/
雄	xl
赛	sq;
略	lxi
杯	bee
施	sio
墙	q;e
环	hfe
罪	fx/
牙	yaz
窗	cp
柳	llei
厅	ttz
搞	gh
端	dro
洞	d/o
适	sm/e
拥	yo
释	smuo
洋	y;o
肩	jr;
魂	hse
闹	nb
蒙	mt
蒙	mgz
洗	xko
灯	dt
借	jxu
伯	bl
免	mf/
菜	cqz
验	yca
凤	fv
鱼	yj/a
徐	xju
型	xgz
娜	nq
娜	nla
暴	bb/
亡	w;;
讨	thoa
辈	bx/e
懂	dl
腿	tdu
灭	mxz
妙	mb
效	xbo
危	we/
优	you
盘	pf/
套	tbz
丁	dtz
趣	qn
妖	yya
束	snzi
杂	fa/
诗	sioa
迎	yg/
舍	sd/
旧	j/i
彩	cau
委	wd/
挂	gqe
笔	bk/
狗	glu
鲜	xrua
鲜	xfu
纸	vka
抗	kpe
探	tce
韩	hfei
尼	nk
控	k/
惜	xkoo
珠	vue
抽	coe
创	cpu
创	cpuo
归	gei
挺	tge
奋	fzz
陪	pd
硬	yve
避	bma
园	yf/a
托	toe
训	xzo
勇	yla
聊	lhe
种	v/u
奶	naa
庄	vp;e
奔	bw
奔	bz
镇	vzu
拳	qf;
采	ca/
研	yfe
配	px
介	jx/
尊	fw;
冒	mb/
虑	ln/
敬	jvei
丹	dr/
舒	suu
蛋	dcai
哼	ht
宋	s/;o
济	jmoo
妇	fna
箭	jc/
择	va
择	fde
犯	fcu
欣	xwu
甲	ja/
欧	ro
课	kxo
扑	pu
菲	fez
菲	fdzi
燕	yczi
曲	qu/
曲	qj/
躲	dlu
玄	xf;
幻	hca
茶	cazi
折	vde
折	sde
伊	yiui
傻	sa
姓	xva
源	yfoo
洛	l/o
遍	bc;a
臣	cszi
弃	qm;
犹	ylu
占	vr/
占	vc/
漂	pyo
漂	pho
漂	pb
挑	ty
挑	the
获	h/zi
绿	lnaa
峰	fti
俊	jzu
疯	ft;
列	lxe
作	fou
森	swz
妻	qiz
恋	lc;
误	wno
拜	bqu
伟	wdu
移	ykue
纳	nqa
党	d;
罢	bq/a
腰	yyu
巧	qh
孤	gua
闭	bm;
圆	yf/a
碰	pv
镜	jvu
软	rf
厚	h/zu
累	ld/
累	lx/
昨	fli
幽	yo/
悲	be/
丈	vpz
牌	pau
降	jpa
降	x;a
颜	yfoe
劳	lhz
偏	pr
省	sg
省	xg/
糊	hjou
糊	hno
馆	gfu
烧	sy
谓	wxo
财	cai
舰	jcuu
汗	hfo
汗	hco
奈	nqz
操	cye
迹	jm;
尸	siae
悄	qho
残	cfe
尖	jr/
鲁	lj
锋	ftu
圈	jc/a
圈	qr/
油	yloo
俩	la
项	xpei
撞	vpe
瞬	szi
忆	ymoo
盖	gq;
尤	ylzu
徒	tju
乡	xpa
概	gqei
户	hn;
荡	dpz
艺	ymz
增	ftei
祖	fjoa
困	kz
殿	dcae
迅	xza
横	hg
横	hv
范	fcz
律	lnu
番	fr/
企	qk/
惨	cfo
限	xcai
聚	jnzi
含	hf/
凭	pg/
剧	jna
碎	sxe
躺	t;u
缘	yfa
凉	l;o
腾	tgu
织	via
抢	qpe
抢	q;ei
预	yna
沈	sso
替	tm
孔	kla
批	pi
康	kp;
惑	h/za
唯	wdi
率	ln;
惯	gco
登	dta
互	hnz
盯	dti
稍	syu
宣	xr;
唱	cpi
诚	cgo
剩	svue
咬	yhi
育	yn;
诸	vuo
触	cnu
晨	cs/
策	cx
疼	tg;
漫	mcoo
材	cae
补	bj
私	siu
吐	tji
吐	tn
纯	csaa
艾	rqz
贝	bx/a
谷	gj/o
庭	tg;e
挡	d;e
晃	h;/a
晃	hp
吉	jkz
吹	cei
仔	fau
仇	clu
凝	ngo
鼓	gje
农	nl;
席	xk;
征	vtu
帅	sqi
附	fnai
缺	qeu
塞	sq;o
塞	sq;o
塞	sx;
豪	hh;e
亦	ym;e
杜	dne
努	nja
判	pco
谋	mlo
胆	dfua
尘	cs/u
扎	vqe
滚	gs
闷	mw;
闷	mz
迟	cka
稳	wsu
翼	ymao
诺	n/o
闲	xf;i
灰	hez
朵	dl/
盛	cgz
盛	svz
梁	l;;o
晶	jt/
餐	cr/
爆	bbo
伦	lsu
娇	jya
侧	cxu
愣	lvo
鼻	bk/i
轮	lse
昏	hw/
抖	dle
陷	xcai
敏	msu
词	cko
慌	hpo
愤	fzo
怜	lfo
颤	cc
阶	jea
苍	cpz
距	jni
郑	vvou
川	cr/i
扫	she
扫	sbe
逼	bi
县	xc/
忧	yoo
童	tl;
执	vkei
丢	do/
荣	rlz
臂	bmae
逐	vjz
傲	rb
戴	dqz
芒	m;z
庆	qv
伴	bcu
袭	xkz
供	gou
供	g/u
积	jiu
测	cxo
遥	yh/
阻	fjai
例	lmui
睁	vti
岛	dh/
遗	yk/
瞪	dvi
慕	mnzi
皱	v/ua
博	ble
幕	mnzi
猜	cqu
益	ym;u
净	jvo
泽	fdo
炼	lco
监	jr/i
鸡	jia
珍	vwe
伏	fjui
绍	sba
曹	chzi
爬	pa/
丫	yq;
炸	vao
炸	vqo
壁	bmae
涌	yloo
凶	xo/o
郎	l;oa
宿	sn;
宿	xl;
宿	x/;
怨	yc/
醉	fxe
拼	pw
迫	p//
革	gdz
瞧	qhi
奥	rb/
输	sue
莉	lmzi
忠	vo/a
颗	kei
嗯	rwi
佳	jqui
旅	ljo
仁	rsu
鸟	nh/
骗	pca
浩	hbo
塔	taei
胖	pp
绪	xna
枫	ftei
拔	baei
赞	fc/
炮	pbo
傅	fnui
凯	kai
邪	xde
芳	fpz
浑	hsoo
夺	dlz
宽	kr
堆	de
裂	lxzu
遭	fy
赤	cmz
旋	xfo
旋	xco
扭	nle
洁	jdoo
浮	fjoo
悉	xi/o
难	nca
擦	cqe
慧	hx
典	df/
赏	s;
匆	co/
评	pgo
纵	f/a
莲	lfzi
雾	wnzo
乌	wu/
跃	yxia
壮	vpoe
贴	tei
丰	ftz
隔	gda
健	jcui
辛	xw;
抵	dke
竹	vju
彻	cxuu
摩	ml;
轰	ho
编	bra
肚	dju
肚	dnu
插	cqei
磨	ml;e
磨	m/;
哎	rqi
御	ynuu
耐	nqe
惧	jno
氏	sm/a
辉	heio
扶	fje
恢	heo
貌	mbu
额	rdo
述	snzi
票	pbz
录	lnae
拖	toei
膀	b;
膀	p;u
鹰	yt;
孟	mva
递	dm;u
瑞	rxe
唇	cszu
暂	fcza
货	h//
琴	qsze
踪	foi
码	mae
慰	wxae
蛇	sdi
玲	lge
晕	yw/
晕	yz/
损	sse
轩	xre
粗	cuo
掩	yfei
屁	pm
悠	yo/i
仰	y;u
零	lgz
盟	mg/
途	tj/
贼	fdia
洪	hlo
悟	wnoo
固	gn/
讶	yqo
冬	do/a
滑	haoo
甜	tfu
郁	yne
琳	lsee
辆	lpe
乃	naau
猪	vuu
暖	nfi
妮	ni
挣	vte
挣	vvei
旦	dc/a
估	guu
坦	tfe
甘	grzi
佩	pxu
莱	laz
享	x;;
吼	hli
构	g/e
粉	fso
萨	sqz
吻	wsi
潜	qfo
瓶	pgou
偶	rlu
戒	jxz
浓	nlo
毁	hdui
销	xyu
迪	dk/
拒	jnei
绕	rba
勒	lxei
勒	le
朗	l;oa
嘻	xiia
尾	wdae
尾	ykae
帐	vpi
废	fx;
延	yf/i
敲	qy
烂	lcou
曼	mc/
厌	yczu
宜	yk;
羞	xo;
喂	wxia
吟	ysi
滴	dio
洲	voo
爹	de/
艳	yce
晴	qgi
抚	fjei
缩	soa
协	xdei
央	yp/
悔	hdoo
肖	xy/
肖	xb/
缠	cfa
脆	cxua
痕	hs;
伍	wju
寂	jm;o
启	qk;a
翔	x;o
薄	bhz
薄	blz
薄	b/
侯	hlui
劝	qc
郭	goo
奴	njau
鸣	mgi
倾	qtu
彼	bku
扔	rt
撒	sqe
撒	sae
豫	ynao
检	jfe
针	vwu
耀	ybi
痴	ci;
姆	mja
篇	pr/
椅	yke
厂	c;zu
董	dlzi
熊	xla
埋	maei
乖	gq/
狐	hju
蒋	j;z
踏	tqi
隆	lla
括	k/e
潮	cho
唉	rqia
穷	ql;
聪	coei
唤	hci
泰	tqze
版	bfu
末	m/z
旗	qko
仪	ykui
焦	jy/
猫	my
盗	db;
侍	smui
挤	jkei
款	kf
拾	ske
荒	hpz
强	q;a
姿	fi;
域	ynei
搭	dqe
脉	mqu
脉	m/u
授	s/e
俗	sju
融	rle
狱	ynua
欺	qie
访	f;o
桥	qhe
锁	slue
霸	bqz
牵	qrz
池	ckoo
钻	fru
钻	fcue
港	g;o
喃	nfia
廷	tg/
乘	cg/
玛	maee
奉	fvz
扯	cd
岳	yx/i
减	jfo
弯	wr
夹	jaz
辞	cku
岸	rc/
岂	qk/a
屈	qua
恼	nho
哲	vdz
季	jm/
召	vba
丧	spz
丧	spzi
尝	c;/o
恭	gozi
载	faz
载	fqz
瘦	s/;e
皆	jez
颇	po
茫	m;zi
染	rf;
肃	sna
爽	s;z
亏	kez
吞	tw
惹	rdz
哀	rq;
乔	qh/
趁	czz
铺	puu
铺	pn
脏	fpu
吕	lj/
奖	j;;
倍	bxu
汤	tp
振	vze
婷	tga
牢	lh;
扰	rh
溜	lo
溜	l/oo
庞	p;;
臭	c//
悦	yxo
赫	hxe
赢	yg;
跪	gxi
麦	mqze
枝	vie
侠	xa
泉	qf/
劫	jde
炎	yf;u
泥	nko
赌	dji
弓	goa
魏	wxu
罩	vb/
疾	jk;
饰	smua
符	fj/e
垂	cd/
映	yvi
漠	m/o
脖	blu
饮	ysua
沿	yfoo
懒	lfoo
肤	fuu
桑	spa
堪	kre
燃	rfo
卓	vl/
祝	vnoa
赖	lqe
宾	bw;
贾	jazi
喘	cfi
焰	yco
吵	chi
冥	mg;
鞋	xdei
逸	ym/a
均	jwe
库	kn
裤	kno
碗	wfeu
航	h;u
踢	ti
姨	ykau
酸	sre
啸	xbi
龄	lgi
阁	gd;
舌	sd/e
箱	xp/e
冯	fg
邦	bpe
钢	gpu
霞	xaz
促	cnui
泡	pboo
盾	dz/
羊	y;;u
碧	bmze
援	yfei
忌	jmae
结	jeaa
抹	mlei
抹	m/e
倩	qcu
锐	rxu
喷	pwi
拦	lfei
嘉	jqz
袖	x/o
殊	sueu
辰	cszu
繁	ff/e
络	l/a
抛	pye
嫁	jqau
咒	v//a
撤	cxe
键	jcue
湿	sioo
恰	qq
虫	cl/
审	ss;
献	xce
媚	mxa
贤	xf/i
葛	gdzi
刹	squ
刹	cquo
袁	yfzi
摔	sqei
序	xn;
筑	vn/
斜	xdu
瓦	wa
涂	tjo
湾	wro
莎	sqzi
崇	cl/a
猎	lxu
刑	xgee
墨	m//
娃	waa
梯	tie
桃	thei
豆	d/z
驾	jqau
浅	qfoo
径	jvuu
饿	rxua
疲	pk;
搬	brei
瓜	gq/u
莹	ygzi
滋	fio
润	rzoo
铃	lgue
蛮	mf;
蒂	dmz
拨	boe
涛	tyo
予	yjao
勾	go/
惠	hxz
析	xie
落	lqz
落	lbz
砍	kfe
撑	cte
截	jdzi
措	c/e
币	bm/
薇	wezi
愈	yn/o
督	du
酷	kne
祥	x;oa
怖	bno
侵	qwu
岩	yf/a
扮	bce
糟	fyo
盈	yga
腹	fnua
斩	vfe
尺	ckae
签	qr/e
稀	xiu
掏	tye
夸	kqz
汽	qmo
液	yxoo
姬	jiau
愧	kxoo
汇	hxo
柱	vne
粮	l;ou
堡	bh/
仗	vpu
笨	bz/
奏	f/z
歉	qco
甩	sa/
怔	vvoo
允	ysao
竞	jv;
祸	h/o
耶	yee
耶	yde
爵	jd/o
绩	jmaa
诱	y/o
呜	wui
穴	xd;o
黎	lk/
租	fuue
培	pde
砸	fae
井	jgz
窝	wo
弥	mka
返	ff/u
匹	pkz
啥	sai
凑	c/o
奸	jra
陌	m/a
叛	pcou
核	hde
核	hje
卧	w/e
幅	fji
眨	vai
耗	hbe
洒	sao
怡	yko
详	x;oa
卢	lj/e
扣	k/ei
哇	wqi
丑	cla
勉	mf/a
孝	xbz
矛	mha
氛	fw/
衡	hgu
陶	tha
购	g/i
汪	wpo
僵	jpu
疗	lh;e
妃	fea
罚	fa/a
系	jm/a
棋	qkei
缝	fga
缝	fva
咐	fni
躯	quu
泛	fco
愁	cl/e
血	xx/
搜	soei
慈	ck;
肥	fdu
笼	ll/e
篮	lf/
俱	jnu
惟	wdo
柜	gxe
捉	voe
悬	xf/a
霍	h/zo
泄	xxoo
咽	yri
咽	yci
齿	ck/
秒	mhu
勤	qse
扩	k/ei
屏	bg
屏	pga
霜	spzo
袍	phoa
蝶	ddi
祭	jm/a
夫	fjz
厨	cjzu
胁	xdua
璃	lke
劈	pia
赚	vci
锦	jsue
尬	gqz
尴	grzu
熙	xiz
寺	smzi
昌	cp/
贺	hxa
巾	jw/a
描	mhe
捕	bje
陵	lgai
咳	kd
扇	sr;
扇	sc;a
虹	hlia
绵	mfa
撕	siei
蔡	cqzi
催	ceu
彭	pge
宠	cl;
贪	tr
辱	rjz
誓	smzi
盒	hd/o
寸	czzi
披	pie
搂	loe
搂	llei
饶	rhu
跌	dei
欠	qc/
肌	jiua
售	s//
巡	xsa
抑	yme
纹	wsa
宏	hl;o
幼	y/a
萍	pgz
驻	vna
丛	cl/o
亿	ymu
播	boei
俄	rdu
刃	rza
蕾	ldz
挨	rqe
仲	v/ui
迈	mqza
违	wdz
辩	bco
埃	rqei
艘	sou
琪	qkee
灾	fq;
僧	stu
渡	dno
卑	be/i
雕	dyu
鼠	sj/
讯	xzoa
辣	lqo
刷	sqa
艰	jrao
斥	cm/
裙	qso
翠	cxa
饱	bhua
掠	lxei
询	xso
勃	blei
夕	xk/
矮	ra
瑶	yhe
赐	cmi
捏	nee
闯	c;;i
姚	yha
瑟	sxz
渴	kdo
谅	lpoa
昂	r;
串	cc/
沟	gooo
涉	sxoo
咕	gui
驶	skaa
摄	sxei
贫	ps/
辕	yfea
婉	wfa
答	dq/e
鹏	pgua
姜	jp;
碍	rqeu
荷	hdz
荷	hxzi
冠	gr;a
冠	gc;
魅	mx/
玫	mdee
裁	cazi
坡	poe
鸿	hloo
邓	dva
歪	wqz
乏	fa/o
申	sw/
割	geo
巫	wuz
衫	sro
棒	bpei
阔	k/;
泣	qmoo
韦	wdze
恍	h;o
贯	gca
魄	p/u
柄	bge
患	hc/
覆	fnz
蜜	mm;
婴	yt/
励	lme
锅	goue
陛	bmai
遮	ve;
帕	pqi
咖	gqi
咖	kqi
嫌	xfau
胳	geu
挖	wqe
啪	pqia
矿	kpeu
凄	qio
爪	vh/
爪	va/
眠	mfi
穆	mnu
啡	feia
吾	wjzi
坛	tfei
脾	pku
恒	hgo
屠	tja
玻	boee
蓉	rlzi
础	cje
曰	ye/
耸	sl/
膊	blua
逆	nm
寿	s/z
驱	quaa
猴	hlua
佣	y/u
毅	ymoe
舅	j//
铜	tlu
娟	jrau
眯	mki
淫	yso
吩	fwi
匪	fdza
牧	mnue
役	ymuu
寄	jm;o
诡	gdo
纤	xra
腐	fj;e
姻	ywau
晰	xiia
渊	yro
亭	tg;e
邀	yy/
哄	hoi
哄	hlia
骚	sya
墓	mnzi
柯	kee
筋	jw/e
崔	ce/
灿	cco
捷	jdei
淋	lso
弗	fjae
辑	jkea
棍	gz
绳	sga
喝	hxi
频	psi
廊	l;;e
畏	wx/
歇	xei
裹	gl;
苗	mhz
盼	pci
咯	geia
咯	loi
咯	l/i
耍	saz
煞	sq/
寝	qs;
瞒	mfia
添	tro
嫂	sha
纠	joa
慨	kao
嚷	r;i
驰	ckaa
拐	gae
宴	yc;
津	jwo
岚	lf/a
浴	yno
耻	ckei
挽	wfei
页	yxzu
誉	yn;o
牲	stue
乳	rju
仓	cp/o
逝	smzi
喉	hlia
逛	gp/
樱	yte
兼	jr;u
戈	gez
哗	hqia
哗	hai
涯	yao
捧	pgei
铭	mgue
障	vpa
摊	tre
跨	kqia
妥	tl/o
揉	rlei
晋	jzzi
寞	m/;o
寨	vq;
漆	qioo
污	wuo
嘲	chia
枚	mdei
吊	db/
乾	qfei
馨	xwz
伪	wdui
嗓	s;i
呈	cg/a
卿	qtua
楠	nfe
籍	jk/e
裸	lloa
链	lcu
灌	gcoo
昆	kw
畅	cpia
逍	xy/o
帽	mbi
阅	yx;i
逗	d/zo
蹲	dw
踩	caia
窜	cc;
哑	yai
趴	pqia
逢	fg/
植	vkei
媒	mdau
韵	yzo
昭	vyi
尹	ysae
谦	qro
档	dpe
趟	tpz
趟	tpzi
沾	vro
兔	tn/
订	dvo
朴	pje
瞎	xqi
鞭	brei
俺	rfu
斤	jw/u
翅	cmzi
肠	c;u
雀	qy/
雀	qh/u
雀	qx/
慎	szo
盆	ps/o
迁	qr/e
镖	byu
芬	fwz
崖	ya/
丘	qo/
蠢	csze
庙	mb;
潘	pro
颖	ygu
拓	t/e
娶	qjz
纱	sqaa
漏	l/oo
谨	jso
珊	sree
和	hxu
仆	pju
曾	ft;u
宙	v/;
尉	ynae
屑	xxa
叮	dtia
捂	wje
涩	sxoo
诧	cqo
柴	ca/e
杆	gre
杆	gfe
涵	hfoo
坠	vx
赔	pdi
涨	v;o
涨	vpoo
嘟	dui
崩	bt/
薛	xez
藤	tgz
税	sxue
枯	kue
译	ymoa
帘	lf;o
糖	t;o
愉	yjoo
骄	jyaa
羡	xc;
糕	gyo
彬	bwe
愚	yj/a
疏	sua
翰	hcei
堵	dje
腕	wcu
眸	mli
芸	ysz
溪	xio
殷	ywu
谎	h;oa
鼎	dg/
稿	ghu
哟	yoi
冤	yr;
症	vt;
症	vv;
棵	keei
狄	dkua
咧	ldi
湘	xpo
宛	wf;
嫩	nz
肆	sme
宰	fa;
憾	hcoo
偿	c;ui
腔	qpu
哩	li
豹	bbu
瑰	geee
鉴	jc/i
绑	b;a
潇	xyo
戚	qizu
郡	jzae
澡	fho
桂	gxei
兮	xi/o
雯	wsz
颠	drei
狮	siua
邻	lsuo
契	qmz
骇	hqa
卜	bo/
卜	bj/
差	cq;
揭	jee
妄	wp;e
坑	kt
伐	faui
矩	jju
烁	s/o
葬	fpzi
诀	jdoa
鄙	bki
鹿	ln;e
柏	baei
柏	blei
溃	kxoo
朕	vzua
舟	vo/u
妆	vpoe
躁	fbi
霉	mdz
侦	vwui
冻	d/oe
娅	yqa
庸	yo;
筹	cl/e
削	xyi
削	xeio
砰	pt
耿	gg
牺	xiue
筒	tl/e
遂	sx;u
旭	xn/
胎	tqu
惶	h;oo
淑	suo
叉	cqa
痒	y;;e
竖	sn/
龟	ge/
斑	bree
儒	rjui
嫣	yra
宅	va;
押	yqe
胃	wx/a
旨	vk/a
册	cx/
膝	xiua
浸	jzo
弦	xfae
栏	lfei
衷	vo;e
刮	gqu
艇	tguu
岗	g;/
赴	fnzi
囊	n;z
斧	fj/o
颊	jae
疆	jpae
炉	ljou
塌	tqe
乞	qk/e
旺	wpi
烤	kho
黛	dq/i
逊	xzai
贱	jci
辨	bcoe
狸	lku
叙	xnu
愕	rxo
叠	dda
遣	qf/a
晌	s;ia
麟	lsoe
腥	xtu
粒	lmo
拟	nke
俏	qb
杖	vpei
芝	vizi
夷	ykz
衬	czo
佐	flui
巷	xpz
捡	jfei
遵	fw;u
塑	sn;u
桶	tlei
泼	poo
滩	troo
琼	qlee
昊	hb/
帆	fri
搏	blei
颈	jga
噢	roi
蹦	bvi
寡	ga;
贞	vw/
凰	h;/a
哨	sbi
拆	cqei
茹	rjzi
劣	lx/u
嘱	vji
沃	w/o
厢	xpzu
摘	vqei
咋	vqi
咋	fai
咋	fdia
坤	kwe
俯	fjui
媳	xkau
赋	fnia
嘶	sii
贡	g/zi
碌	lne
匙	ck/a
拢	llei
谭	tfoa
翁	wt
辜	guz
竭	jdoe
廉	lf;e
械	xxe
贸	mb/a
辅	fjea
讽	fgo
呐	nqi
斌	bwo
辽	lha
填	tfei
窃	qx;
抄	cyei
溢	ymoo
妒	dna
吁	xui
吁	yni
嗦	soi
掀	xrei
芙	fjzi
祈	qkoa
栋	d/e
吱	vii
撇	pe
撇	pdei
胞	byua
轿	jbea
禅	cfoa
禅	sco
妨	f;au
拂	fjei
倦	jcui
衰	sq;e
靖	jvoe
循	xsu
挪	nlei
蓬	pgzi
惩	cg/u
垃	lqei
账	vpia
驳	bla
署	sj/a
甫	fjzi
顽	wfee
姥	lhau
圾	jie
熬	rhz
枕	vse
丐	gqzi
茜	qcz
咦	yki
厕	cxz
攀	prz
彤	tlua
妍	yfau
拽	vqei
荆	jte
妓	jmau
壶	hjz
寇	k/;o
鹤	hxoa
钥	ybu
骤	v/a
渺	mho
刊	kree
肢	viua
烛	vjo
孕	yza
绽	vca
彦	yc;e
棉	mfe
俘	fjui
盔	kezu
剪	jf;u
诞	dcoa
兜	do/i
凛	lsoe
岭	lgia
嚣	xy/a
溅	jcoo
笛	dk/e
舱	cpuu
罕	hf;a
鸭	yqi
债	vqu
噬	smi
钉	dtu
钉	dvu
躬	goui
倚	ykui
缕	lja
咚	doi
撼	hcei
蕊	rdzi
侄	vkui
佑	y/ui
雁	yczu
隶	lma
践	jcia
拱	gle
沐	mno
菊	jjz
蜂	ftia
裕	ynoa
兆	vbu
搅	jhe
尿	nba
黯	rci
歹	dazu
蓄	xnz
朦	mgua
嘀	dki
怯	qxo
叨	dyi
纽	nlaa
聘	pz
腻	nmu
剥	boa
彪	by/
沸	fxo
氓	mgo
卷	jc;
榜	b;e
榜	bpei
榜	pve
逻	ll/a
壳	kdz
壳	qbz
储	cju
憋	be;
啤	pki
匠	jpz
悍	hcoo
昧	mxi
泊	blo
泊	pooo
篷	pg/e
烫	tp;
狡	jhu
轨	gdea
汹	xoo
携	xdei
磊	ldzu
隙	xmai
仑	ls/
摧	cee
瞄	mhi
胧	llu
趋	quz
挠	nhe
煌	h;ou
擅	scei
卒	cn;
卒	fj;e
饼	bgu
狭	xau
丸	wf/
惫	bx/a
瞅	cli
卡	qa
犬	qfz
砖	vre
矣	ykao
楞	lve
昔	xizi
裳	sp/o
裳	c;/o
骆	l/aa
雇	gn;
阎	yf;i
骷	kui
鸦	yqea
妞	no
墅	sn/a
焚	fsz
谱	pjo
属	vja
绘	hxaa
梳	suei
肿	vlu
魁	kd/
耽	drei
擒	qsei
陡	dla
璋	vpee
茂	mbz
蹄	tki
瞥	pe;
瞳	tli
髅	lli
绣	x/a
硕	s/eu
肺	fxu
参	cwa
参	swao
参	sra
兹	fi;u
炒	chou
邮	yli
弘	hlae
嫉	jkau
届	jxa
嗡	wti
娱	yjau
喧	xri
脂	viua
膛	t;ua
沧	cpo
疚	j/;
盐	yfzi
扁	bf;
扁	pr;
搁	geei
茅	mhzi
滔	tyoo
坟	fse
掐	qqe
瑜	yje
邱	qou
桐	tlei
茵	ywz
苹	pgzi
旷	kpi
翘	qbza
郝	hhe
蓦	m/zi
诈	vqoa
沫	m/oo
菁	jtz
粹	cxou
琢	vle
腊	lqu
钦	qwue
喻	ynia
宪	xc;o
锻	dcue
睹	djia
郊	jyo
饥	jiua
侃	kfu
粘	vrou
媛	yfau
谊	ymoa
恳	ksa
厮	siz
锤	cdu
凳	dvao
淮	haoo
蔽	bmzi
聂	nxz
贩	fci
潭	tfoo
翩	proa
呻	swi
枉	w;e
拘	jue
煮	vjzi
焉	yrz
址	vkei
匕	bk/a
渗	szoo
览	lf/i
敦	dwo
厦	sqzu
蕴	yzz
冉	rf/
薪	xwzi
呃	rxi
峻	jzi
荐	jcz
栽	fqzi
嚎	hhi
汁	vio
傍	bpu
秃	tu/
磕	keeu
禀	bg;
珑	llee
坎	kfei
邵	sbau
萌	mgzi
窄	va;o
阮	rfa
蹈	dhi
碑	beeu
婶	ssa
煤	mdo
寓	yn;o
栈	vcei
滞	vmoo
倘	t;ui
杭	h;e
暇	xai
藏	fpzi
狈	bxua
峡	xaia
侣	lju
芦	ljz
蔓	mcz
蒸	vtz
禄	lno
胀	vpua
醋	cne
淌	t;oo
伞	sf/
姊	fka
钩	goue
衍	yfu
妾	qx;e
嘎	gai
蜀	sj/a
蝴	hji
萝	llz
莽	m;zi
弩	njau
祷	dho
稚	vmue
圳	vzei
徽	heu
衙	yau
咸	xfz
陋	l/ai
奢	sez
罐	gcu
霄	xyzo
毙	bmza
汝	rjo
敞	c;i
暮	mnzi
嘘	xuia
灼	vlo
澜	lfoo
姗	srau
倪	nku
挫	c/ei
咪	mi
钧	jwu
捣	dhe
燥	fbo
泳	yloo
眶	kpia
乙	ykaa
澈	cxoo
焕	hcou
酬	cle
筷	kq/
宵	xy;
揪	joe
缚	fnaa
蚁	ykia
喇	lai
丞	cgai
拎	lw
吓	hxia
棠	t;/
咙	llia
梭	soei
哧	cii
棺	grei
璇	xfe
瀚	hcoo
肝	gru
敛	lfu
剂	jmoe
疤	bq;
渔	yjoo
嗔	cwi
沮	jjo
廖	lb;
虏	lj/e
皓	hbu
勋	xwi
恕	snau
虐	nx/
虞	yj/e
综	foa
瘾	ys;
驴	ljaa
晒	sqia
卦	gqei
迦	jqau
陀	tlai
窥	ke;
堕	d/a
哆	doia
葡	pjz
帖	tdi
垫	dcz
屡	ljae
鹅	rdue
蛛	vui
盲	m;;
碟	dde
狞	ngu
囚	ql/
诊	vso
揽	lfei
裴	pd/
捞	ly
吏	lmzi
铮	vtue
萄	thz
盏	vfz
霆	tgzo
喔	woi
贷	dq/i
给	jkaa
勿	wn/a
吭	kti
淘	thoo
辟	bmae
辟	pma
蔑	mxzi
淹	yroo
麒	qkoe
喽	loia
栗	lmzi
绷	bta
惚	huo
桓	hfei
坊	fpe
桩	vpei
嗽	s/i
履	ljae
璐	lnee
菩	pjzi
巢	cha
畜	cn;e
畜	xn;e
兀	wnzu
樊	ffz
锡	xiue
棚	pgei
仕	smui
倏	suui
芹	qszi
僻	pmu
絮	xnau
杏	xvzi
浆	jp;e
浆	jp;e
啧	fdia
瘫	tr;
磁	ckeu
冈	gp/a
逮	daa
逮	dqa
搓	coei
赠	fvi
胶	jyu
脊	jk;e
噩	rxzi
绰	c/a
呕	rli
嚼	jhi
嚼	jdi
谐	xdo
舍	sx/o
歼	jre
揣	cqei
揣	caei
殖	vkeu
拧	nge
伺	cmu
伺	smui
霖	lsz
驼	tlaa
襄	xp;
衔	xfuu
惕	tmo
掷	vmei
卸	xxu
炽	cmo
敖	rhe
惭	cfoo
框	kpei
捆	kse
眩	xci
蝉	cfia
谜	mko
炫	xcou
塘	t;e
阱	jgai
膜	mlu
亨	ht;
奕	ym;e
蚂	mai
蚂	mqia
猩	xtua
滨	bwoo
沁	qz
跋	bai
藩	frz
舔	tfue
捐	jrei
歧	qki
隋	sdai
蹭	cvi
甄	vwei
蜡	lqia
嗤	ciia
缸	gpue
嬉	xia
哮	xyia
熄	xiou
窍	qb;
俞	yj/o
豁	haoo
豁	hoo
豁	h/oo
垒	lda
掘	jdei
琦	qkee
屎	skae
乍	vq/
孽	nxzi
毯	tf/e
弧	hja
槐	hae
铠	kau
挟	xdei
襟	jwoa
梨	lk/e
嗅	x/i
祁	qkoa
纲	gpa
渠	qj;
矢	sk/e
捅	tlei
扛	k;e
朽	xle
忖	cso
匈	xo/a
扒	bqe
扒	pae
雍	yo;e
莺	ytzi
侮	wjui
闺	ge;
霓	nkz
斋	vq;e
稽	jiue
夭	yy/e
沦	lsoo
揍	f/e
瞟	phi
苟	glz
琉	llee
漪	yio
暑	sj/a
窟	ku;
钓	dbue
鳞	lsua
瓷	ck;e
萱	xrz
株	vuei
倭	wou
鞘	qbe
沛	pxo
噜	lu
绞	jha
颓	tdue
睿	rx/
噗	pui
唔	wji
幢	vpia
喀	kqia
诅	fjoa
涕	tmoo
拣	jfei
谣	yho
叽	jii
葱	coz
拭	smei
婢	bmau
铸	vnu
绮	qkaa
剿	jhaa
胤	yzua
秩	vmue
畔	pcia
粥	voae
奎	kdzu
绸	claa
茨	ckz
觉	jb;
熏	xw/
蹬	dvia
诏	vbo
岔	cq/
叭	bqia
咆	phia
滥	lcoo
梧	wjei
垮	kae
澳	rbo
浙	vxo
甸	dc/a
绯	feaa
诛	vuoa
鲍	bbua
刁	dya
厥	jdzu
蚊	wsia
鞠	juei
歆	xwo
拙	voei
茗	mgzi
眷	jc;u
戮	lnao
唬	hjia
骏	jzaa
扳	brei
踹	cqi
漓	lkoo
蝇	ygi
擂	lxei
涡	woo
沌	dzo
凸	tu/e
蚩	cia
酿	np
唾	t/i
琐	sle
犀	xiae
澄	dvoo
澄	cgoo
哉	fqzi
猾	hau
煎	jr;u
窒	vm;
虾	xqia
蝠	fjia
钞	cyu
瓣	bcoe
唧	jiia
觑	qni
哽	ggi
娥	rda
婿	xnau
讪	scoa
耕	gt
葫	hjzi
暧	rqia
浇	jyoo
嗨	hqia
诵	s/oa
疫	ym;e
兢	jtei
箫	xy/e
颅	lji
啼	tkia
绅	swaa
杉	srei
嗜	smia
券	qc;
遁	dz/u
炯	jlo
霎	sqzo
讥	jioa
迭	dd/
彷	p;uu
觅	mm/
娴	xfau
抿	mse
剔	tii
稻	dbue
敷	fue
泻	xxoo
怠	dqao
龚	gozu
绒	rlaa
讳	hxoa
勺	sh/
函	hfa
喳	cqia
颂	s/u
搀	cre
撩	lye
擎	qgz
巍	we/a
脯	fjua
脯	pjua
镶	xpue
寥	lh;o
漾	ypo
缴	jhaa
藉	jkzi
藉	jxzi
弊	bm;u
逞	cg/a
膏	gy;
戳	coa
呛	qpi
凹	ry
叩	k/i
禽	qs/
懊	rboo
懈	xxoo
蛟	jyi
亢	kp;e
呸	pei
芊	qrzi
慑	sxoo
跺	d/i
跄	qpia
蚀	skua
栖	qiei
蔚	wxzi
铲	cfue
坪	pgei
筝	vt/
顷	qge
腮	squa
别	bxi
踉	lpi
划	haea
当	dp/
狰	vtua
踱	dli
嗖	soia
苑	yczi
秉	bg/
猿	yfua
堤	die
佟	tlui
悯	mso
唠	lhi
唠	lbi
憨	hra
肘	vlua
拇	mjei
僚	lhu
霹	piz
婕	jdau
禹	yj/i
啃	ksi
匀	ys/
颤	vcoe
晖	heia
怅	cpoo
聋	llzu
拯	vge
忿	fz/
韧	rze
邹	foua
梢	sye
肋	lxua
窘	jl;
嵌	qc/a
婪	lfzi
辖	xae
浦	pjoo
炭	tc/
曦	xiia
簇	cn/
螺	llia
酱	jp;e
屯	ts
悴	cxoo
匡	kpz
冀	jm/e
倔	jdui
橙	cge
陕	sfa
筱	xh/
叱	cmia
髓	sdia
淳	csoo
矜	jwao
詹	vr/a
菱	lgzi
芷	vkz
惺	xto
浊	vloo
囔	npi
朔	s/ou
憔	qhoo
睫	jdia
睬	caia
鸽	geuo
臀	tsa
吨	dwi
笙	st/e
戟	jkei
沼	vho
谍	ddo
昕	xwia
蛊	gj/a
煜	ynou
祀	smoa
罡	gp/a
伶	lgui
荫	ywzi
荫	yzzi
酥	suei
懦	n/oo
厄	rxzu
峨	rdi
轴	vlea
伽	jqui
雳	lmzo
卵	lfua
捶	cde
檐	yfei
棘	jkei
嗣	smia
钗	cque
袜	wqo
妩	wja
炕	kpo
偎	weu
窦	d/;o
蝎	xeia
溶	rlo
膨	pgua
峙	vmi
缉	jiaa
徊	hauu
呗	bei
衅	xzu
砂	sqeu
舵	d/u
昼	v/ae
迸	bv;u
斟	vwei
舆	yj/i
椒	jye
靓	lpee
旬	xs/
厘	lkzu
窑	yh;
萎	wdzi
涟	lfoo
疙	ge;e
瘩	dq;
瘩	da;
梵	fczi
靴	xee
侥	jhui
匿	nmz
挚	vmzi
镯	vlue
兑	dx;
尧	yhz
徘	pauu
芽	yazi
狙	juu
闵	ms;
辫	bcoe
瀑	pno
嗷	rhi
庐	lj;
芯	xwzi
禾	hd/e
澎	pgoo
邢	xgee
绊	bcaa
蜘	viia
憎	fto
靡	mk;e
褚	vjoa
湛	vcoo
蒲	pjzi
嚓	cqia
珂	keee
崽	fa/a
贬	bfi
惮	dcoo
婵	cfau
嗒	tqia
悸	jmoo
晦	hxia
涅	nxo
恬	tfoo
慷	kpoo
穹	ql;o
渣	vqoo
屉	tma
缭	lhaa
绢	jcaa
袱	fjoa
黝	ylia
袅	nh/a
淇	qkoo
茄	jqzi
茄	qdz
寅	ys;o
赦	sxei
祟	sxa
榻	tqei
蛙	wqia
苇	wdzi
嵩	so/
茉	m/zi
咏	ylia
凿	fh/
粪	fz;
噪	fbia
菌	jwzi
蝙	bri
庶	sn;e
邸	dkua
禧	xkoa
攒	ffe
旱	hc/a
虔	qf/e
榴	llei
琛	cwee
漱	snoo
忑	txz
匣	xaza
忐	tf/e
谬	m/oa
蟒	m;i
棱	lgei
钝	dzu
悚	slo
廓	k/;e
惘	w;o
漉	lnoo
蟹	xx/a
佬	lhui
曳	yx/a
赎	sji
壤	r;e
忡	coo
倡	cpui
冶	ydo
竿	gr/
蜷	qfi
癌	ra;
嘈	chia
蚕	cfz
剖	pooe
颁	bruo
缀	c/aa
汀	tto
谕	ynoa
牡	mju
斐	fd/
懵	mgoo
分	fz/o
斗	dl;
皙	xizi
缪	mba
缪	mla
蔷	q;z
诫	jxo
恤	xno
咄	doia
馒	mfu
矫	jhue
痞	pk;e
橘	jje
氧	y;/
贿	hxia
肮	rpu
瑾	jse
烙	lbo
璧	bmae
攘	r;ei
攥	fce
肖	xb/o
汰	tqo
溺	nmo
铅	qru
咔	kaia
芭	bqzi
戎	rlza
褐	hxoa
巩	glei
吆	yyi
彰	vpoe
漩	xfoo
聆	lgei
蒜	scz
棕	foe
鹃	jri
帜	vmia
鄂	rxia
搐	cnei
蔼	raz
怦	pto
穗	sxue
亩	mj;
撰	vcei
绎	ymaa
牟	mlao
咨	fi;e
奄	yrzu
梓	fke
亲	qv;
绚	xcaa
阀	fa;i
烘	hoou
炙	vm/a
翎	lguo
惋	wfo
驯	xzaa
栩	xje
逾	yj/o
墟	xue
鬟	hfz
茬	cazi
褪	txo
鑫	xw/o
骸	haia
峭	qbi
缅	mfaa
灶	fbou
洽	qqo
祯	vwo
暄	xria
裔	ym;e
韶	sho
缎	dcaa
砚	yceu
锥	veu
辙	vdea
惦	dcoo
铛	ctu
枣	fhz
桦	hqei
邃	sx;o
橱	cjei
搔	syei
腑	fjua
解	xxua
萤	ygzi
枢	suei
遏	rx/a
募	mnzi
憬	jgo
庵	rr;
叼	dyia
嫖	pha
苛	kezi
锣	llue
蹑	nxi
拌	bcei
奠	dc;u
秽	hxue
殴	roe
喋	ddia
糙	cyo
貂	dyuo
揖	yie
葵	kdzi
榆	yjei
颐	ykei
皂	fb/
眈	dri
扼	rxei
眺	tbi
孜	fia
簌	sn/e
玺	xk/a
偌	r/u
蹿	cri
蓓	bxz
弛	ckae
庇	bm;e
檀	tfei
枭	xy/a
螂	l;i
趾	vki
崭	vf/
妲	daau
掂	drei
醇	cse
掺	crei
驿	ymaa
槽	che
惬	qxoo
镰	lfue
抡	lwe
憧	cooo
删	sru
鸳	yr/
酣	hre
宦	hc;
筐	kp/
琅	l;e
瞻	vri
飙	byeu
湃	pqoo
俨	yfui
跷	qyi
栅	vqei
栅	srei
撅	jeei
煽	srou
呱	guia
缰	jpaa
猝	cnua
衮	gs;
肴	yh/o
殆	dqeu
谴	qfoa
蔬	suzi
飒	sqoe
婧	jva
阐	cf;i
荧	ygzi
侈	ckui
霏	fezo
瘟	ww;
芜	wjzi
俭	jfu
崎	qkia
亥	hq;e
俐	lmui
屿	yji
譬	pmae
饺	jhua
垄	llzu
畴	clia
杠	gpe
鬓	bzz
讼	s/oa
晏	yc/a
弈	ym;e
鞍	rre
瘸	qd;
钮	nlu
珏	jdee
钰	ynue
傀	kdu
噔	dtia
驭	ynaa
靶	baei
萦	ygzi
韬	tyee
恙	yp;
懿	ymei
竺	vj/
吝	lz;
羁	ji/
荀	xsz
癫	dr;
嘭	pti
菇	guzi
恃	smoo
儡	ldu
瘪	be;e
瘪	bd;
踌	clia
呦	yoia
榕	rlei
昵	nmi
躇	cji
烬	jzou
啰	loia
酌	vlei
丙	bgz
涎	xfoo
哒	dqi
冽	lxoe
砌	qme
鸾	lf;e
烨	yxou
翟	vaa
翟	dka
辗	nfea
噎	yei
驹	jua
噼	pii
咎	j//a
亵	xx;
陨	ysai
蠕	rji
冕	mf/a
雌	cki
茸	rlzi
瑛	ytee
剃	tmou
掰	bque
蹙	cnz
橡	xpei
佯	y;ui
笃	dj/
崛	jdia
勘	krei
稼	jque
桀	jd/a
渝	yjoo
汐	xioo
锈	x/u
磅	bpeu
壕	hhei
娄	ll;
撮	coei
撮	fle
玑	jiee
祠	ckoa
娲	wqa
鹫	j/;e
黏	nfu
珀	p/e
睽	kdi
栓	srei
绫	lgaa
阑	lf;i
邑	ym/a
瑕	xaee
磋	coeu
粟	snzi
薯	sjz
沪	hnoo
讷	nxoa
岑	cs/a
炜	wdou
玮	wde
娼	cpa
迂	yu
伎	jmu
鲸	jtu
翡	fd/e
坝	bqei
铐	kbu
洼	wqoo
蹊	xiia
寐	mx;
肾	sz/
鸯	yp/a
敝	bmo
涧	jcoo
崆	ko
甭	bgzu
笠	lm/
扈	hn;a
哝	nli
芮	rxzi
卉	hxzi
靳	jze
诬	wuoa
札	vae
婊	bha
裘	qlz
扉	fe;
疮	cp;
巅	dr/a
坞	wne
膳	scu
鳄	rxua
捺	nqei
悼	dboo
茧	jfz
毋	wjaa
曙	sjia
馅	xcu
簸	bl/
簸	b//
忒	tez
奇	jizu
叟	sl/i
拴	srei
嬷	mqa
稣	suua
痹	bm;e
垣	yfei
蛤	gdi
蛤	haia
谏	jcoa
羹	gt;
沥	lmoo
蛾	rdia
瑚	hjee
熔	rlou
惆	clo
雏	cjua
饷	x;u
拗	rbe
拗	n/e
燎	lho
熠	ymou
薰	xwzi
蕃	ffzi
捋	lje
籁	lq/
髦	mhzi
飓	jn/a
簿	bl/e
簿	bn/e
迢	thau
闸	va;i
狩	s/ua
鲨	sq;o
蜥	xiia
惴	vxoo
胯	kqu
侨	qhu
劭	sbau
烹	pt;
咣	gpia
攸	youi
锄	cjue
硝	xye
颔	hcu
鸥	roea
滕	tgua
寰	hf;o
紊	ws;e
蕉	jyz
稠	clue
蟆	maia
垢	g/ei
楷	kaei
炊	ceo
忻	xwoo
炳	bgo
腆	tfua
褒	by;
酋	ql;u
赃	fpi
拈	nr
拈	nfei
抒	suei
孰	sjo
袄	rho
褂	gqoa
孺	rja
胭	yru
赘	vxz
嫡	dkau
礁	jyeu
啜	c/i
钳	qfue
晾	lpia
茎	jtzi
隧	sxai
窿	ll;o
骋	cgaa
嫦	c;a
掳	ljei
槛	kfei
莞	gfzi
莞	wfz
瓢	phe
曜	ybia
锯	jnue
猖	cpua
遐	xaa
蹋	tqia
飕	so/a
渍	fmo
麾	he;
猥	wdua
篝	go/e
殉	xze
枷	jqe
蜒	yfi
皎	jhui
霁	jmz
诩	xjo
窖	jb;o
咫	vkae
檬	mge
乒	pt/
奚	xi/o
淤	yuo
父	fj/o
溯	snoo
凋	dyo
纺	f;aa
篱	lk/e
泌	mmo
刨	bbua
刨	phu
樵	qhei
忏	ccoo
盎	rp/
戾	lm;a
阿	re
咀	jji
屹	ymi
冲	c/oe
挎	kqei
羔	gy;u
殃	ype
庚	gt;e
淼	mh/
淀	dcoo
隘	rqai
绛	jpaa
缨	yta
璨	cce
跤	jyia
锵	qpue
摁	rzei
痊	qf;e
嫔	psa
臻	vwea
泯	msoo
糜	md;
睦	mni
喵	myi
缥	pya
褥	rno
魇	yfzu
汶	wzo
馋	cfua
渎	djoo
蜿	wri
抠	koe
诶	reo
墩	dwe
棣	dme
沓	tq/
喏	rdia
诲	hxoa
琶	paz
缈	mhaa
缔	dma
酝	yze
耷	dqzu
弼	bmae
柬	jfzi
浏	lloo
拷	khe
剁	d/ua
柿	smei
琵	pkze
沂	ykoo
捻	nfei
帛	bl/i
柠	ngei
饵	rku
撂	lbe
娓	wdau
乓	pp/
轲	keea
髯	rfz
娉	pta
尽	jsa
圭	gezi
璀	cdee
苔	tqzi
苔	taz
肪	f;ua
吮	ssi
瞩	vjia
啄	vli
帷	wdia
箍	gu/
蟑	vpia
炖	dzou
梗	gge
捎	syei
嗬	heia
蘑	mlzi
唏	xiia
鹊	qxei
矶	jieu
羌	qp;
骼	gdia
筛	sq/e
鲤	lkua
羲	xi;
祺	qkoa
馈	kxu
伫	vnui
羿	ymao
苞	byz
犁	lk/e
啬	sxzi
舷	xfuu
矗	cnzi
癖	pk;e
掣	cx/e
匾	bfz
瀛	ygo
谧	mmoa
珞	l/e
毓	ynue
衲	nqo
恺	kaoo
纬	wdaa
惰	d/oo
嘤	yti
诣	ymoa
谛	dmo
藻	fhzi
啷	lpia
佘	sd/o
黠	xaia
饲	smua
虬	qli
涤	dko
骡	llaa
钵	bou
邯	hfei
笋	ss/
芥	jxzi
醺	xwe
佼	jhui
舜	sz/o
龌	w/i
簪	fr/e
痰	tf;
论	lsoa
蹂	rlia
恻	cxoo
簧	h;/e
甥	stue
腼	mfua
单	cf;u
单	sc;u
驮	tlaa
缤	bwa
潺	cfoo
獠	lhua
筏	fa/e
锭	dvue
阙	qe;
阙	qx;i
粤	yx/i
瞌	keia
琏	lfee
龊	c/ie
椎	vee
唆	soia
煦	xn/a
嵋	mdi
幡	fria
翌	ymao
毡	vr/e
碳	tceu
鸨	bhua
闽	ms;i
躏	lzi
蜓	tgi
咻	xoi
捍	hcei
睨	nmia
鼾	hru
桔	jjei
娆	rha
抉	jdei
蜻	qti
徨	h;uu
嗲	dai
碾	nfeu
哐	kpia
粼	lsou
啐	cxi
谑	xxoa
嚏	tmi
鳖	be;u
榨	vqei
倜	tmu
稷	jmue
篡	cc/e
晤	wni
肇	vb;
咂	fqi
帚	vla
瘤	ll;e
瞠	cti
嚅	rjia
怆	cpoo
撵	nfei
裆	dpo
腺	xcua
骁	xya
坷	kde
螃	p;i
冢	vl;a
锢	gnu
濒	bwoo
蝗	h;i
烽	ftou
莘	swzi
辘	lnea
撬	qbei
瓮	wv
亘	gzz
钊	vyu
篓	ll/e
缇	tka
宸	cs;
胄	v//a
鞑	dae
羚	lgou
绥	sdaa
笺	jr/e
荤	hwz
迄	qm/e
踞	jnia
桨	j;;e
慵	yooo
噤	jzia
幌	h;ia
跚	sri
袒	tfoa
浣	hcoo
榄	lfei
痪	hc;e
荼	tjzi
阉	yr;i
腋	yxu
骰	tlia
曝	pni
涮	scoo
踵	vlia
炬	jnou
涣	hcoo
俟	smui
皑	rau
瞑	mgia
渲	xcoo
擞	slei
赂	lni
湮	yroo
麓	lnzi
铿	ktu
埔	pjei
峦	lf;e
涓	jro
掬	juei
怏	ypoo
莓	mdzi
萃	cxzi
呲	fii
蹒	pfi
鳌	rhze
睐	lqia
昱	yn/a
和	hjue
和	h/ue
旌	jtoe
摞	l/ei
吠	fxi
濮	pjoo
谙	rro
啕	thi
轶	ymea
搪	t;ei
陇	llai
纨	wfaa
膺	yt;e
皋	gy/
霭	razo
呓	ymia
橄	gfei
纶	lsa
垛	d/ei
嗫	nxia
盅	vo/a
踝	haia
臧	fpzu
淅	xioo
岌	jk/a
岱	dq/i
璞	pjee
缄	jraa
秧	ypu
翱	rhui
卤	lj/e
逅	h//u
靥	yxzu
磐	pf/u
壑	hx/
斓	lfoe
翊	ymoe
挛	lf;e
叁	srao
佗	tlui
阖	hd;
怂	sl/o
戬	jfei
汲	jko
垠	yse
迥	jl/a
咛	ngi
邂	xx/a
杞	qkei
痘	d/;e
臊	sbu
藕	rlzi
媲	pmau
湄	mdoo
癞	lq;
辄	vdea
獒	rhze
恪	kxoo
砾	lmeu
痉	jv;e
蜕	txi
椰	yeei
差	ci;u
仨	squi
纣	v/aa
馁	nd
蜈	wjia
镐	ghue
窈	yh;o
秤	cvu
粱	l;;o
辐	fjea
悖	bxo
涔	csoo
偕	xdui
渭	wxoo
汴	bcoo
蜴	ymia
桅	wdei
隅	yjai
卯	mhua
骜	rbz
孚	fj/o
禺	yj/a
琥	hjee
杵	cjei
掖	yeei
畸	jiia
晔	yxia
婀	rea
菡	hcz
噶	gaia
昙	tf/a
坍	trei
俑	ylui
滤	lnoo
侏	vuui
潦	lhoo
挲	so;
硫	lleu
俸	fvu
蟠	pfia
弋	ymza
梆	bpei
驸	fnaa
笈	jk/e
忱	csoo
恿	ylao
龟	jw/a
胥	xua
垦	ksae
窕	th;
滇	droo
珅	swe
圃	pj/
咿	yii
徙	xku
瘴	vp;e
舫	f;uu
嗝	gdia
泞	nvo
藐	mhzi
赣	gcoe
鹦	ytia
逵	kdzi
戍	snzu
榭	xxei
揩	kqei
熹	xizi
蟾	cfia
霾	maz
蔫	nrz
跛	bli
岐	qkia
脐	qku
糗	qlo
螳	t;i
哺	bji
鹭	ln/a
蚣	goi
嵬	wd/a
褶	vdo
恸	t/o
隽	jc/i
玥	yxe
籽	fko
釜	fj/o
剐	gaia
鸠	jou
磷	lseu
娑	so;o
巳	sma
谄	cfoa
恣	fm;
猬	wxua
酪	lbei
丕	pizu
溟	mgoo
隼	ss/i
芋	ynz
觊	jmi
筵	yf/e
娣	dmau
盹	ds
涸	hdoo
劾	hdoe
颌	hduo
殇	spe
轧	yqea
沽	guo
愫	snoo
鸢	yrza
玷	dcee
掸	dfe
溥	pjoo
疵	ci;e
皖	wfu
杳	yhzi
镀	dnue
祎	yioa
鹉	wjee
匍	pj/a
崴	wa/
岖	qui
幔	mci
蝈	goia
镑	bpue
臆	ymua
偃	yfui
蜗	woia
瞰	kc
侬	nlui
郸	drou
缆	lfa
袂	mxo
诠	qfoa
犊	djue
摹	mlzi
蟀	sqia
邋	lqa
竣	jzoe
骥	jmaa
泗	smoo
痣	vm;e
贲	bwz
胴	d/ua
潼	tlo
弑	smuo
匐	fj/a
姣	jyau
谤	bpo
蘸	vcz
蟋	xiia
渥	w/oo
浒	hjoo
蛐	quia
阂	hd;i
糯	n/ou
愠	yzoo
嵇	jiue
谒	yxoa
舀	yh/o
否	pkzu
呤	lgia
槟	bwei
嘣	bti
脓	nlua
樟	vpei
忪	vooo
蛰	vdzi
咤	vqia
阜	fn/i
峥	vtia
濡	rjoo
遢	tq/a
担	dfei
瑙	nhee
碉	dye
孵	fuua
讹	rdoa
彝	ykaa
颀	qkuu
篆	vc/e
臾	yj/i
椭	tlei
沏	qioo
颦	ps/e
蛆	quia
淆	xho
揄	yjei
压	yqzu
嗑	kxi
踮	dfi
犷	g;u
荔	lmzi
鳅	qoua
闫	yf;i
隗	wdai
渤	bloo
馍	mlua
锏	jfue
楣	mdei
蜃	szz
遛	l//
查	vqz
倌	grui
氤	yw/e
戌	xuz
嶙	lsia
馗	kd/a
匮	kxza
揶	ydei
胚	peu
啻	cm;
敕	cmei
夙	sn/a
珈	jqee
锹	qyu
摒	bve
迩	rk/a
啾	joi
峪	ynia
菠	boz
馥	fnue
槌	cdei
褛	ljoa
贻	ykia
礴	bleu
豚	tsu
氲	yw/e
湍	troo
腌	yrua
蚱	vqia
殡	bze
毗	pkia
耙	paee
诽	fdoa
褴	lfoa
瘁	cx;
蚌	bpi
铝	ljue
蔻	k/z
憩	qm/e
锚	mhue
濑	lqoo
耘	ysee
俾	bkui
鬃	foz
裟	sq;o
苒	rfzi
蘅	hgz
鱿	ylua
傥	t;ui
袈	jqau
豺	cauo
町	tgia
掇	doe
坯	piei
戛	jazu
贮	vnia
塾	sj;e
剽	pyei
孬	ny
衩	cao
镣	lbu
戊	wnzu
犟	jpae
酉	ylzi
斡	w/ei
匝	fqza
诘	jdoa
攫	jdei
潢	h;oo
黔	qfia
臃	youa
罂	yt/a
轼	smea
酗	xne
嘹	lhia
阪	bfa
冗	rl;
桧	gxei
皿	ms/
囡	nr/
辍	c/ea
觎	yju
浚	jzoo
闰	rz;
臼	j//i
蹩	bd;u
煲	by/i
怵	cno
囤	ts/
罔	w;/a
蚓	ysia
碴	caeu
灸	jl/a
蚯	qoi
嗥	hhia
堑	qcza
箴	vw/e
谗	cfoa
嵘	rlia
箩	ll/e
碱	jfeu
葆	bhzi
旎	nkoe
谆	vwoa
粽	f/o
牒	ddu
泸	ljoo
刽	gxu
诋	dkoa
缜	vsa
爻	yh/o
贰	rmz
坳	rbei
睑	jfi
葭	jqzi
妪	ynau
镂	l/u
癸	gdao
笆	bq/e
壬	rs/
绉	v/aa
抨	pte
叵	plz
箕	ji/e
坨	tlei
颉	jdei
姹	cqau
赳	joz
焊	hcou
淬	cxoo
纭	ysaa
埠	bne
泱	ypoo
恹	yroo
榛	vwei
酵	jbei
銮	lf;e
佶	jku
犒	kbue
茱	vuz
饪	rzu
孪	lf;e
砺	lmeu
遽	jn/e
嗟	jei
钙	gque
谚	ycoa
鲲	kwu
谟	mloa
馊	soua
雉	vmue
虱	siau
糠	kpou
赈	vzi
旮	gq/a
骠	bya
峋	xsi
跆	tai
瘠	jk;e
饕	ty/
佚	ymui
淄	fioo
谀	yjoa
镳	byue
读	d/oa
廿	ncz
喟	kxia
偻	llui
绺	llaa
骨	gu/a
沱	tloo
囱	co/i
兖	yf;e
袤	mb;e
畿	jiaa
诌	vooa
苯	bsz
佻	tyu
魈	xy/i
屌	dhae
谲	jdoa
泾	jtoo
獗	jdua
蹶	jdia
绔	kna
雹	bhzo
旯	la/
洱	rko
馄	hsua
粲	cc/e
哂	ssia
蔗	vxzi
饨	tsua
奘	fpa
芍	shz
淞	soo
腴	yjua
剜	wroo
汾	fsoo
顼	xuee
濂	lfoo
蜚	fd/e
殒	yseu
鹞	ybuo
蚤	fha
浃	jqo
坂	bfe
颚	rxia
忤	wjo
眦	fmi
彗	hxze
暹	xr/
赧	nfei
佝	goui
钺	yxue
嘞	lei
硅	geeu
玳	dqee
蛹	ylia
睾	gy/i
盂	yjze
赁	lz/
瑁	mbe
骛	wna
宕	dp;
纂	ff/e
堰	ycei
厩	j/z
萋	qizi
帔	pxi
杈	cqei
熨	yzae
挞	tqei
觐	jzei
煊	xro
钏	ccu
泫	xcoo
迳	jvao
缮	sca
燧	sxou
孱	cfae
懑	mz;
柩	j/e
漕	choo
鹄	hjue
龛	kr/
饯	jcua
餮	txzu
幄	w/ia
鹘	gji
倨	jnui
诙	heoa
锃	fvue
颧	qfei
纰	piaa
鏖	rh;
氢	qt/
楔	xeei
藜	lkzi
栀	viei
谥	smoa
骧	xpaa
犄	jiue
葳	wezi
魑	ci/
聒	goei
椿	cwei
伢	yaui
谩	mfo
鹜	wnao
燕	yrzi
闩	sr;i
颍	ygua
濠	hho
仞	rzui
鳗	mfua
踊	ylia
痿	wd;
皈	geui
骊	lka
孑	jdai
帼	gli
撸	lue
檄	xke
啵	boi
柚	y/e
篑	kx/
陲	cda
潋	lcoo
樽	fwe
遨	rhze
舶	bluu
莆	pjzi
蛀	vnia
抻	cwei
搽	caei
俪	lmui
铉	xcue
嚯	h/i
茁	vlz
韭	jl/e
膘	byua
酩	mgei
榔	l;ei
娩	mfau
汗	hcoo
刎	wsua
扪	msei
漳	vpoo
仃	dtui
饬	cmua
壹	yizi
裨	bmoa
裨	pko
巽	xzae
黜	cni
滂	ppo
鹂	lkei
徉	y;uu
戕	qpa
埂	ggei
纫	rzaa
溉	gqoo
胛	jau
锌	xwue
遑	h;/i
跻	jiia
蒿	hy
钛	tque
岷	msi
葩	pqz
磺	h;eu
汕	scoo
肛	gpua
涿	vooo
鲛	jyua
睥	bmi
滦	lfoo
稔	rsue
锲	qxu
徜	c;uu
冼	xfoe
獐	vpua
喙	hxia
讧	h/oa
氨	rr/
褓	bho
赊	sei
菀	wfzi
鄱	plu
炅	gx/a
碜	cseu
戗	qpuo
瓴	lguo
酊	dgei
钠	nqu
镌	jru
铀	ylue
羯	jdou
挝	woe
襁	q;o
渚	vjoo
胫	jvua
雎	jui
砥	dkeu
衢	qju
狒	fxua
骞	qr;
荟	hxzi
华	ha/i
号	hb/a
正	vtzi
石	dczu
汛	xzoo
色	sa/a
盥	gc/
睚	yaia
栎	lmei
砣	tleu
烩	hxou
夯	hpzu
拮	jdei
驷	smaa
殓	lce
哔	bmia
徇	xzuu
蹴	cnia
忾	kqoo
疹	vs;
鸵	tlua
韫	yzee
祛	quo
膻	srua
黢	quia
仄	fxz
唳	lmi
烊	y;ou
烊	ypou
孀	spau
腚	dvua
牍	djui
佃	dcui
赡	sci
秣	m/ue
榷	qxei
镭	ldue
铄	s/ue
嫒	rqau
饽	boua
谌	csoa
啮	nxia
蝼	llia
闱	wd;i
篙	gy/e
逡	qwa
膑	bzu
隍	h;a
罄	qvz
蕨	jdzi
呢	nki
囵	ls/a
橹	ljei
睢	seia
喱	lki
肓	hp;
榈	ljei
绶	s/a
槊	s/;u
罹	lk/a
槁	ghe
秸	jeue
裱	bhoa
牦	mhue
滓	fkoo
腓	fdua
砝	faeu
舐	smue
谶	czoa
秆	gfue
荏	rsz
斛	hjua
暨	jmae
滟	ycoo
纾	suaa
粑	bqo
诳	k;o
寮	lh;o
鹑	csoe
驽	njau
囫	hj/a
徕	lau
弭	mkae
橇	qye
痢	lm;e
圜	hf/a
撺	crei
柑	grei
儆	jgu
魉	l;/i
妊	rzau
氏	vi/
酶	mdei
庖	ph;
缢	ymaa
俎	fjuo
鲫	jmua
藓	xfzi
佰	bau
痔	vm;e
觥	goua
哞	moi
伉	kpu
怄	r/o
轱	gue
泵	bvz
擀	gfei
蝌	keia
绌	cna
蓑	soz
釉	y/uo
翳	ymza
讫	qmoa
蜇	vez
蜇	vdzi
砧	vweu
殄	tfeu
萼	rxzi
胰	ykua
蜍	cjia
瘀	yu;
鸪	guei
霰	xcz
鹧	vxoe
诨	hzoa
僭	jcui
弁	bcao
湎	mfoo
栉	jdei
蹉	coi
醍	tkei
磬	qvzi
泷	lloo
蓼	lhzi
铂	blue
梏	gnei
鸩	vzo
豌	wre
嘬	foia
疡	y;;e
荞	qhz
涝	lboo
蛔	hdi
焖	mzo
祉	vko
魍	w;/i
跎	tlia
锉	c/u
桎	vmei
喆	vdei
娠	swau
诿	wdoa
瓯	roea
殚	dreu
镁	mdu
痂	jq;
胱	gpua
刍	cj/
醐	hjei
糅	rlou
愎	bmoo
赝	yczu
唁	ycia
笳	jq/
崂	lhia
踽	jjia
鳍	qkua
帧	vwi
骈	pfa
仟	qrui
羸	ld;
谪	vdoa
狲	swua
槃	pf/u
珲	heee
蛭	vmia
痍	yk;e
猢	hjua
鼹	yfui
悌	tmoo
莅	lmzi
咩	mei
誊	tg;u
鳝	scua
韪	wd/a
噱	jdia
俚	lkui
硌	gxeu
脍	kqua
汞	glzi
淖	nbo
姘	pwa
聩	kxe
泅	qloo
喑	ywi
绦	dkaa
铡	vau
恽	yzoo
遒	ql;u
痨	lh;e
蚪	dlia
蒺	jkzi
觞	spua
葺	qmzi
煅	dcou
悱	fdoo
茕	qlzi
靛	dcee
诓	kpoa
箔	bl/e
珥	rke
岬	jai
臬	nx/i
肱	goua
焙	bxou
鸷	vmzi
蜢	mgia
莠	ylzi
铨	qfue
胺	rcu
堇	jsz
嶂	vpia
钾	jaue
跹	xria
鹌	rreu
笞	ci/e
缛	rna
椽	cfei
苕	thzi
酮	tlei
婺	wnao
貉	hduo
囿	y//a
铣	xkue
舂	coze
碘	dfeu
馔	vcua
铢	vuue
涪	fjoo
氯	ln/e
傣	dau
度	dl;e
篾	mx/e
猕	mku
砒	pieu
颛	vria
柒	qi;
饴	ykua
圩	wdei
疱	pb;
圄	yj/a
枸	glei
貅	xouo
蛎	lmia
唢	sli
窠	ke;o
囹	lg/
撷	xdei
伥	cpui
疟	nx;
傩	nlui
诟	g/o
嗞	fiia
赅	gqia
楂	vqei
氮	dc/e
竽	yj/e
碣	jdeu
谔	rxoa
铧	haue
铆	mhue
滁	cjo
遴	ls;
舛	cfua
荠	jmzi
稞	keu
阄	jo;
荚	jazi
媪	rhau
悒	ymoo
笏	hn/
晷	gd/a
宥	y/;
豸	vm/o
摈	bzei
凫	fj/a
阡	qra
粕	p/o
癣	xf;e
珐	fqe
馏	llua
龈	ysie
锒	l;ue
虻	mgia
腩	nfua
吖	rqia
瓤	r;o
楫	jkei
镊	nxu
阆	lp;i
豕	skzu
擘	b/a
玎	dte
馐	xoua
潍	wdoo
龅	byi
黩	djia
芪	qkzi
砭	breu
腱	jcua
挈	qxz
怼	dxao
嬗	scau
貔	pkuo
杷	paei
讴	roo
铬	gxue
沆	hpoo
蝮	fnia
烷	wfou
箜	ko/
揿	qze
茴	hdzi
鲈	ljua
昴	mh/a
缟	gha
瘙	sb;
痫	xf;e
矾	ffeu
氖	na/e
烯	xiou
铰	jhue
妯	vlau
耄	mbzi
搦	n/ei
飨	x;aa
鳏	grua
痼	gn;e
讣	fno
馕	n;u
鲇	nfua
妁	s/au
垩	rxzi
枇	pke
幂	mm;a
蟊	mhao
萁	qkzi
鹳	gce
盱	xuia
帑	t;a
侪	caui
娌	lkau
煸	bro
孳	fi;u
蚋	rxia
脔	lf;e
箬	r//e
樯	q;ei
趸	dsz
苣	jnzi
萸	yjzi
謇	jf;o
妣	bka
啁	voi
氰	qg/
蒹	jrz
莴	woz
夤	ys/a
鹬	ynao
腭	rxua
鲑	geua
淦	gcoo
鲠	ggu
蚝	hhia
瀣	xxoo
骐	qkaa
堀	kuei
柞	f/ei
泔	gro
锰	mgue
蟥	h;ia
薅	hyz
嵯	clia
蛳	siia
篦	bm/e
荜	bmzi
焯	cyou
芡	qczi
螯	rhze
眙	ykia
肄	ymua
荨	qfzi
耋	ddz
俳	paui
铱	yiue
薮	slzi
笄	ji/e
渑	mfoo
豉	ckei
疣	yl;e
镍	nxue
轳	ljea
熵	spo
瘆	sz;
杼	vnei
诂	gjo
鲶	nfua
氟	fj/e
洄	hdoo
孢	byai
郴	cwei
詈	lm/a
鞣	rlei
蜉	fjia
耦	rlee
蛉	lgia
箪	dr/e
愆	qr/u
藿	h/zi
痱	fx;e
纡	yua
葚	szzi
黧	lk/e
毖	bmza
髋	kri
坻	dkei
蜊	lkia
铙	nhu
漯	tqoo
骟	scaa
捌	bqei
椴	dcei
墒	spei
溘	kxoo
牖	ylui
蹚	tpi
阋	xm;
龋	qji
刈	ymuo
悭	qroo
蠲	jrou
瓠	hne
圪	geei
轾	vmea
麸	fuee
锱	fiu
瞽	gjz
糍	ckou
蹼	pji
鳕	xdua
偬	flui
榫	ssei
秭	fku
瘢	br;
殍	pheu
碇	dve
碓	dxe
孓	jdai
痧	sq;e
痈	yo;e
埚	goei
壅	yo;e
怙	hnoo
癔	ym;e
潆	ygoo
檩	lsei
痤	cl;e
嘚	deia
菽	suzi
茭	jyzi
酰	xrei
菏	hdzi
诹	foo
粳	jtou
糌	fro
舸	gdu
趵	bbi
枥	lmei
膈	gdua
傧	bwu
鸬	ljie
艿	naz
酚	fwei
椟	djei
氦	hq/e
笸	pl/
疸	df;
醛	qfei
篌	hl/
枳	vkei
酯	vkei
髫	thzi
缳	hfaa
孥	njau
溧	lmoo
镬	h/ue
卺	jsai
皴	cwao
鍪	mlao
坩	grei
砻	llzu
郯	tfou
筚	bm/e
跬	kdia
醚	mke
蚧	jxi
肽	tqua
绀	gcaa
顸	hree
谵	vroa
鲟	xsua
屣	xkae
鹚	ckou
焗	jjou
疖	je;
炝	qpo
啉	lsia
硒	xieu
伛	yjui
蛄	guia
燹	xfzu
缫	syaa
髀	bmia
凇	sooe
鼙	pkzi
悛	qroo
轫	rzea
苷	grzi
羝	diou
蘖	nxzi
蚍	pkia
桡	rhei
耨	n/ee
搴	qr;o
榧	fdei
蚜	yaia
轭	rxea
皲	jwoa
胝	viua
蝣	ylia
鲋	fnua
硼	pgeu
葸	xkzi
溏	t;oo
鲱	feu
溽	rnoo
滏	fjoo
彖	tca
耜	smee
嫠	lkze
锂	lkue
劬	qjua
颟	mr
曈	tlia
濞	bmoo
郫	pkui
怍	f/oo
螨	mfia
阈	yn;i
肫	vwua
蝰	kdia
蝓	yjia
暌	kdia
蒌	llzi
颞	nxe
鲷	dyua
囟	xz/
溴	x/oo
畚	bsa
癜	dc;e
辊	gse
嘌	pyi
烃	ttou
柽	ctei
秕	bkue
豇	jpe
蛞	k/ia
颃	h;oe
骶	dkia
鳔	bbua
髂	qqi
瘘	l/;e
胗	vwua
髌	bzi
楦	xcei
籼	xrou
齁	hou
骒	kxa
堙	ywe
袪	quoa
酞	tqei
鲻	fiua
氪	kx/e
去q	qnzi
起q[	qkzie
前q]	qf;u
我w	wl/e
为w[	wx;u
无w]	wjze
他t	tqui
她t[	tqau
天t]	trze
一y	yize
有y[	ylzui
也y]	ydai
是s	sm/ae
说s[	sxoao
上s]	sp/e
人r	rs/o
然r[	rf/a
而r]	rkzu
的d	dmui
得d[	dduu
地d]	dmei
在f	fqzu
自f[	fm/i
发f]	fqau
个g	gx/o
过g[	g/zio
更g]	gtzi
会h[	kq/o
好h	hbau
还h]	hfzu
将j[	jpoe
就j	j/oe
间j]	jc;i
可k	kdzii
看k[	kr/e
空k]	k/;oa
了l	leai
来l]	lazo
里l[	lk/ae
下x	xqzi
心x[	xw;a
小x]	xh/u
成c[	cgzu
出c	cuai
从c]	cluo
这v	vx;e
中v[	v//ae
只v]	vk/ae
不b	bnzu
把b[	bqeie
被b]	bxoa
你n	nkui
能n[	ngao
那n]	nqae
没m	m/ooe
吗m[	mqiae
明m]	mgiae
到p	dbea
大p[	dqzuo
都p]	duei
