去	q
起	q[
前	q]
我	w
为	w[
无	w]
他	t
她	t[
天	t]
一	y
有	y[
也	y]
是	s
说	s[
上	s]
人	r
然	r[
而	r]
的	d
得	d[
地	d]
在	f
自	f[
发	f]
个	g
过	g[
更	g]
会	h[
好	h
还	h]
将	j[
就	j
间	j]
可	k
看	k[
空	k]
了	l
来	l]
里	l[
下	x
心	x[
小	x]
成	c[
出	c
从	c]
这	v
中	v[
只	v]
不	b
把	b[
被	b]
你	n
能	n[
那	n]
没	m
吗	m[
明	m]
到	p
大	p[
都	p]
