让	w,
我	w
若	w.
是	s
说	s.
事	s,
的	d
到	d.
对	d,
有	f
也	f.
要	f,
用	y
又	y.
与	y,
过	g
给	g.
更	g,
他	t,
她	t.
它	t
这	z
着	z.
真	z,
去	q
却	q.
全	q,
和	h.
好	h,
还	h
将	j.
就	j
即	j,
可	k
看	k.
快	k,
了	l
来	l,
两	l.
不	b
把	b.
被	b,
你	n
能	n.
呢	n,
没	m
吗	m.
每	m,
想	x
向	x.
像	x,
次	c.
才	c,
从	c
在	r
最	r.
再	r,
都	p
当	p.
但	p,
一	yi
人	rs
个	gx
上	sp
们	mw
大	dq
道	dv
子	zk
中	zo
那	nq
为	wx
出	cu
么	me
时	sk
地	dm
得	dd
下	xq
以	yk
里	lk
然	rf
自	zm
之	zi
天	tr
而	rd
小	xg
会	hx
后	h/
心	xw
生	sy
家	jq
起	qk
多	do
只	zk/
于	yj
面	mc
点	df
样	yp
所	sl
头	tl
如	rj
作	z/
手	sl;
华	ha
方	fp
些	xe
无	wj
现	xc
年	nf
国	gl
知	ziu
文	ws
成	ch
前	qf
老	lg
己	jk
发	fq
身	sw
话	hq
法	fa
见	jc
笑	xv
开	kq
意	ym
学	xd
已	yk/
本	bs
很	hs
经	jy
分	fw
儿	rd;
太	tq
同	tl/
声	syv
行	xh
十	skv
三	sr
回	hd
情	qh
实	sk;
种	zl
动	d/
间	jr
定	db
明	mh
力	lm
气	qm
其	qkv
眼	yf
走	zlv
进	jz
女	nj
二	rx
几	jk;
长	c;
因	yw
此	ck
问	wz
数	sn
正	zb
理	lke
神	ss
先	xr
高	gt
外	wq
者	zd
打	da
应	yb
便	bc
算	sc
信	xz
等	dh
日	rm
相	xp
听	ty
主	zj
白	ba
并	bb
系	xm
觉	jd
口	kl
光	gp
西	xi
别	bd
边	br
使	sku
机	ji
少	sg
怎	zs
候	h/u
处	cn
表	bg
住	zn
体	tk
门	ms
四	sm
关	gr
由	yl
第	dm;
名	mh;
月	yx
果	gl/
比	bk
象	xp;
做	z/u
结	jda
性	xb
感	gf
新	xwo
位	wxu
色	sx
重	z/;
常	c;/
张	zp
风	fy
接	je
何	hdu
军	jw
死	skvu
东	dov
战	zc
脸	lf
字	zm;
水	sd
平	ph
件	jcu
许	xj
通	to
书	su
部	bn
计	jm
王	w;
放	fpo
吧	bq
直	zkv
连	lfv
完	wf
量	lp
难	nfa
统	tla
叫	jv
变	bc;
似	smu
工	go
空	ko
清	qy
亲	qw
入	rn
五	wjv
公	go;
立	lm;
息	xi;
内	nx
据	jn
且	qd
写	xd;
语	yjo
原	yfv
山	sr/
望	wp
加	jqa
教	jve
轻	qye
程	chu
度	dn
思	si
特	tx
花	hqv
吃	ci
则	zdi
或	h/v
命	mb
合	hd;
马	ma
今	jw;
路	ln
提	tke
化	hqu
海	hao
解	jdu
目	mn
必	bm
带	dqv
民	ms/
士	smv
爱	rq
非	fe
图	tj
虽	se
该	gq
至	zmv
世	smvi
言	yf;
美	md
安	rr
活	hl
龙	ll
式	smva
物	wn
总	zl;
任	rz
形	xhe
远	yfve
受	s/
跟	gw
乎	hu
金	jw;o
义	ym;
论	lz
强	q;
代	dqu
微	we
满	mf
题	tk/
坐	z/;o
钱	qfu
车	ce
半	bc;u
飞	fe/
反	ff
指	zke
啊	rqi
报	bv
服	fj
找	zg
类	lx
黑	he
界	jx
转	zce
李	lkv
制	zmu
传	cf
记	jmo
师	sii
往	w;u
怕	pq
刚	gpi
夫	fu
各	gx;
容	rl
及	jk/
管	gf;
步	bn/
红	hla
城	che
音	yw;
火	hl;
干	grv
利	lmu
句	jn;
万	wc
姐	jdau
九	jl
魔	ml
模	mle
条	tg
场	c;e
流	llo
识	sko
青	qyv
切	qe
百	bav
云	ys
早	zg/
求	ql
北	bdi
八	bq;
办	bc/
近	jz;
设	sxo
房	f;
随	sda
集	jk;i
喜	xk
失	si;
务	wn;
离	lk;
孩	haa
告	gv
兵	by
术	snv
电	dc
决	jdo
影	yh
拿	na
认	rzo
交	jt
极	jke
谁	sdo
器	qm/
站	zco
竟	jb
请	qho
林	ls
始	ska
友	ylv
灵	lh
落	l/
精	jyo
够	g/
刻	kx
单	dr
越	yxv
拉	lq
深	swo
存	cs
哪	nai
父	fn
队	dx
七	qi
示	smve
冷	lho
元	yfve
根	gwe
惊	jyoo
哥	ge
杀	sq
功	goe
斯	sie
紧	js
消	xt
收	so
兴	xy
静	jbe
保	bgu
般	bru
整	zh
周	zo;
母	mj
石	skvu
怪	gqo
送	s/;
星	xy/
击	jiv
阵	zz
爷	yd
型	xhv
苦	kj
基	jivi
男	nf/
族	zjo
忙	m;
未	wxv
弟	dm;u
六	l/;
复	fn;
衣	yi;
确	qx
敢	gfa
片	pc
奇	qkvu
故	gn
究	jo
南	nfv
答	da;
取	qj
妈	mq
谈	tf
客	kx;
底	dk
备	bx
绝	jdaa
期	qke
网	w;/
足	zj/
英	yy
血	xx
线	xca
慢	mco
千	qr
准	zso
格	gd
易	ym/
包	bt
夜	yx;
热	rxv
树	sne
显	xf
构	g/e
照	zv
员	yf/
突	tu
终	zoa
业	yx/
块	kqe
运	yz
令	lb
估	gu
暗	rc
双	spa
众	z/;o
古	gj
引	ysa
态	tqv
尽	jz/
布	bnv
修	xo
留	ll;
武	wjve
晚	wfi
创	cp
断	dco
调	tgo
官	gr;
德	ddu
响	x;
错	c/
建	jc/
达	dav
曾	ch;
嘴	zdia
低	di
欢	hr
诗	sio
尔	rd;a
罗	ll/
标	bte
改	ga
需	xu
领	lhu
乐	lx;
破	p/
玉	yn
产	cf;
阳	y;
级	jka
序	xn
组	zja
急	jk;a
黄	h;
技	jme
院	yc
脚	jg
章	zp;
愿	ycv
木	mnv
忽	hu;
段	dcu
帮	bp
号	hv
除	cj
久	jl;
视	smo
伤	spu
念	nc
细	xma
阿	rqa
造	zv;
团	tf/
冲	co
值	zku
具	jn/
节	jdv
陈	csa
跑	pg
乱	lc
词	cko
简	jf
京	jy;
势	smvi
依	yiu
持	cke
展	zf
科	ke
朋	phu
装	zp;e
渐	jco
较	jvea
艺	ymv
娘	n;
异	ym/e
另	lb/
台	ta
品	ps
规	gee
兰	lf;
读	dj
市	sm;
须	xuu
玩	wfe
克	kxv
屋	wu
观	gra
速	snvi
社	sxoa
差	cq
哈	hqi
围	wd
画	hqvi
穿	cr
况	kp
倒	dg
罢	bq/
研	yfe
约	ye
换	hc
注	zno
呀	yq
饭	fc
沉	cso
层	ch/
害	hq;
支	ziv
户	hn
睛	jyi
称	cy
角	jg;
索	slv
政	zbe
雷	ld
参	cr/
摇	yg
待	dquu
假	ja
希	xi;o
朝	cg
丝	si/
宝	bg;
首	sl;u
楚	cjv
联	lfe
攻	goei
船	cfu
佛	fl
香	xp;e
初	cuo
秋	qo
雪	xdv
诉	sno
斗	d/;
库	kn
病	bb;
旁	p;
选	xf;
您	ns
既	jma
丽	lmv
赵	zvv
酒	jlo
背	bx/
举	jj
痛	t/
争	zy
杨	y;e
叶	yxi
密	mm
散	sce
群	qs
戏	xmao
讲	j;
司	si/e
证	zbo
汉	hco
雨	yjv
志	zmvi
露	lnv
旧	j/
校	xve
皇	h;;
派	pqo
篇	pr
赶	gfv
停	th
喝	hei
楼	lle
议	ymo
呼	hui
试	smoa
护	hne
推	te
境	jbei
环	hf
刘	lloe
脑	ng
资	zi;
亚	yqv
居	ju
妹	mx
亮	lp;
睡	sxi
肯	ks
局	jj/
梦	mbv
编	bra
掉	dve
置	zm/
甚	sz
例	lmui
印	yzu
疑	yku
属	sj
买	ma/
姑	gua
恐	klv
敌	dku
江	jp
概	gqe
招	zt
查	ca
共	g/v
威	wev
跳	tv
咱	zfi
续	xna
兄	xo/
鬼	gd;
谢	xxo
淡	dcoo
洋	y;o
素	snve
专	zr
刊	kr
顾	gne
永	yl;
游	ylo
顺	szu
控	k/
刀	dt
胡	hj
状	zpo
致	zme
区	qu
止	zk/e
仙	xru
帝	dm;e
顿	dz
络	l/a
商	sp;
软	rfe
述	snvi
严	yfvi
礼	lko
考	kg
习	xk/
冰	byo
左	zlvu
余	yj;
料	lv
否	flv
效	xvo
堂	t;
史	sk/
输	sue
忘	wp;
短	dfu
燕	ycvi
历	lmvu
味	wxi
仿	f;u
烟	yr
巴	bq/i
靠	kv
顶	dhe
杂	za
采	ca;
维	wda
岁	sx/
独	dju
皮	pk
怀	haoo
君	jw/
页	yxvu
仅	jsu
圣	sb
笔	bk;
排	pa
操	ct
钟	zou
景	jh
土	tjv
妇	fna
列	lxe
凤	fb
巨	jnv
充	co;
闪	sf
广	g;
验	yca
激	jio
费	fx
铁	td
闹	nv
权	qfe
坏	hqe
齐	qk;
板	bf
质	zm;u
继	jmaa
莫	m/
剧	jna
耳	rdv
翻	fr
忍	rs/
压	yqvu
源	yfo
恶	rxvi
治	zmo
按	rce
伙	hlu
球	qle
馆	gfu
春	cw
苏	suv
默	m/i
抱	bve
配	px
府	fj;
射	sxu
隐	ysai
退	tx/
河	hdo
卷	jf;
课	kxo
毛	mg
右	y/
狂	k;
卫	wx/
烈	lxv
际	jmai
奶	naa
略	lxi
某	mlv
仍	rh
端	dro
价	jqu
守	sl;o
弄	n/
封	fye
呵	heia
划	hqea
枪	qp
孙	swa
胜	sbu
助	zni
吴	wj/
缓	hfa
卖	mqv
唐	t;;
负	fn;a
域	yne
适	sm;e
演	yfoo
福	fjo
窗	cp;
导	dg/
梅	mde
米	mk
哭	ku
免	mf;
率	ln;
波	bo
讨	tgoa
增	zye
蓝	lfvi
怒	nn
掌	z;
超	ctv
限	xcai
遇	yn/
码	mae
秀	x/
珠	zu
贵	gx/
松	soe
室	sm;o
虎	hj/
兽	s/;u
歌	geei
纸	zka
草	cgv
练	lca
茶	cav
叹	tc
施	sioe
纪	jmaa
含	hf;
沙	sqo
供	g/u
桌	zo/
剑	jcuo
测	cx
街	jeu
爸	bq;o
肉	r/
灯	dy
刺	cm
座	z/;e
优	yo
曲	qj/
束	snvi
抗	kpe
醒	xhei
闻	ws;
责	zdv
舞	wj;
版	bfu
凡	ff;
虚	xu/
防	f;a
追	ze
银	ysu
床	c;;
唱	cpi
归	gei
泪	lxo
吸	xii
伯	bl
译	ymoa
范	fcv
温	ww
挥	hee
救	j/e
检	jfe
替	tm
祖	zjoa
份	fz
麻	ma;
眉	md/
阴	ywa
描	mge
毕	bmv
幸	xbv
良	l;
互	hnv
伸	swu
雅	ya
预	yna
盘	pf
革	gdv
秦	qsv
熟	sj;
园	yf/a
柔	rl/
险	xfa
骑	qka
股	gju
析	xie
禁	jzv
阶	jea
逃	tg;
猛	mhu
征	zyu
州	zo;u
灭	mxv
担	dce
医	yiv
藏	c;v
警	jhv
乡	xp/
副	fne
啦	lqi
野	ydi
承	ch/i
拍	pqe
秘	mmu
陆	lna
喊	hfi
项	xpe
骂	mq/
养	y;;
寒	hf;o
婚	hw
恨	hz
混	hzo
架	jq/
呆	dq/
弹	tfa
宇	yj;o
丁	dyv
懂	dl
败	bqi
普	pj
甲	ja/
协	xde
晓	xgi
迷	mk;
善	sc;
墙	q;e
亦	ym;e
移	ykue
绿	lnaa
凌	lhoe
曼	mc/
卡	ka
执	zkei
烦	ffo
抓	zq
献	xce
察	ca;o
宫	go;o
智	zm;e
投	tle
硬	ybe
田	tf/a
闲	xf;i
厉	lmvu
趣	qn
介	jx;
瑞	rxe
亡	w;;
宣	xr;
牛	nl
借	jxu
释	smuo
叔	sui
抬	tae
摆	bae
弱	r/a
偷	tou
误	wno
脱	toua
寻	xs
宗	zo;o
案	rc;
富	fn;o
握	w/
紫	zk/e
罪	zx
悲	be
评	pho
抽	coe
敬	jbei
店	dc;
湖	hjo
药	yv
徐	xju
付	fnu
朱	zu;
材	cae
食	sk;o
扬	y;ei
尚	sp/
狗	glu
圆	yf/a
琴	qsve
仁	rsu
峰	fyi
震	zzv
鼓	gje
魂	hse
姓	xba
坚	jr/
骨	gj/
午	wj;e
毫	hg
欲	ynu
透	t/;
探	tce
惜	xko
鲁	lj
托	toe
洞	d/o
临	lsi
营	yhv
缺	qeu
芳	fpv
牙	yav
绍	sv
虑	ln/
雄	xl
柳	llei
辑	jkea
洗	xkoo
凭	ph;
录	ln/e
婆	pl
孔	kla
迎	yh;
升	sy;
勇	yl/
村	cwe
省	sh
巧	qg
迅	xz/
尊	zw
偏	pru
菜	cqv
套	tvv
党	d;
妙	mv
烧	st
萧	xtv
避	bm/
择	zde
挂	gqei
批	pi
函	hf/
职	zkei
灰	hev
拥	yoe
闭	bm;
育	yn;
胸	xou
浪	lpo
拜	bqu
怜	lfo
尤	ylvu
欧	ro
休	xoui
狠	hsu
腿	tdu
哼	hy
辈	bx/e
纷	fwa
牌	pau
妖	yt
策	cx;
羽	yja
危	we;
袋	dq;
获	h/vi
符	fj;e
夏	xqv
伟	wdu
彩	cau
诸	zuo
荣	rlv
幽	yo/
劳	lgv
丈	zpv
训	xzo
键	jcue
狼	l;u
油	yloo
稍	stu
恩	rw
博	ble
庆	qb
奋	fzv
碎	sxe
固	gn/
遍	bc;a
班	bre
碰	pb
横	hh
颜	yfoe
济	jmoo
附	fnai
舍	sd;
殿	dca
赞	zc;
载	zav
肩	jr;
鱼	yj;a
农	nl;
尖	jr/u
登	dy/
唯	wdi
童	tl;
轮	lse
厅	tyv
缘	yfa
炼	lco
鲜	xrua
著	znv
补	bj
纳	nqa
典	df/
沈	sso
困	kz
佩	pxu
庄	zp;e
毒	djv
迹	jm;
聚	jnvi
杯	bee
织	zia
厚	h/vu
吓	xqi
飘	pt
吹	cei
嫂	sga
宽	kr;
曰	ye/
娜	nqau
享	x;;
均	jwe
丹	dr;
凉	l;o
丰	fyv
访	f;o
冒	mv/
腰	ytu
扑	pu
隔	gda
躲	dlu
竹	zju
宋	s/;o
慧	hxv
淑	suo
嘿	heia
昨	zli
插	cqe
席	xk;
惯	gc
翠	cx/
圈	qr/
杰	jdvi
委	wd;
徒	tju
陪	pd
积	jiu
判	pco
拳	qf;
舒	suu
映	ybi
残	cfe
莲	lfvi
折	zdei
剩	sbue
律	lnu
壁	bm/e
堆	de
朵	dl;
缩	soa
尼	nk
迟	ck/
幻	hca
抵	dke
距	jni
触	cnu
镜	jbu
悄	qgo
诚	cho
瞧	qgi
庭	th;
降	jpa
私	siu
汗	hcoo
纯	csaa
针	zwu
括	k/e
递	dm;u
询	xso
惨	cfo
幕	mnvi
鼻	bk;i
减	jfo
猜	cqu
抢	q;ei
玄	xf;e
镇	zzu
丢	do;
犹	ylu
胖	pp
谓	wxo
炮	pv
径	jbuu
遗	yk/a
赛	sq;
末	m/v
妻	qiv
穷	ql;
弃	qm;
忠	zo/a
财	cai
浮	fjoo
忆	ymoo
哦	r/i
胆	dfua
彼	bku
疯	fy;
扩	k/ei
孤	guai
皱	z/ua
稳	wsu
晨	cs/
辛	xw;
宜	yk;
爆	bvo
番	fr;
梁	l;;
益	ym;u
乃	na/
傲	rv
凝	nh
犯	fcu
净	jbo
锋	fyu
瞬	szi
咬	ygi
箭	jc;
洛	l/o
挺	the
荡	dp
逐	zjv
皆	jev
躺	t;u
宁	nh;
赏	s;
俗	sju
翼	ym/o
愤	fzo
劝	qc
旅	ljo
迫	p/;
赤	cmv
旗	qko
贝	bx/a
厂	c;vu
岛	dg;
鸣	mhi
昏	hw;
塔	taei
臂	bm/e
逼	bi
授	s/e
尘	cs/u
阻	zjai
欣	xwu
尸	si/e
康	kp;
舰	jcuu
椅	yke
伊	yiui
鸟	ng;
森	swv
氏	sm;a
娇	jta
寂	jm;o
粉	fs
汽	qmo
鸡	jia
吉	jkv
监	jr/i
芒	m;v
匆	co;a
臣	csv
货	h/;
鸿	hlo
拟	nke
途	tj;
慰	wx/e
晶	jy/
蛋	dc/
猫	mt
颗	kei
累	lx/
陷	xcai
壮	zpoe
芬	fwv
努	nj/
奥	rv;
票	pvv
菲	fev
敏	msu
延	yf;i
仰	y;u
吟	ysi
恋	lc;
颤	cc
县	xc/
杜	dne
滚	gs
蒙	mhv
忧	yoo
暂	zcv
恢	heo
振	zze
粗	cuou
零	lhv
俩	la
毁	hdui
伴	bcu
轰	ho
戴	dqvi
奈	nqv
矩	jju
仇	cl
盛	sbv
漫	mcoo
撞	zpe
偶	rlu
嘛	mqi
颇	po
惑	h/va
慕	mnvi
伦	lsu
擦	cqei
厌	ycvu
伏	fju
枝	zie
慌	hp
废	fx;
挤	jkei
吾	wjvi
启	qk;a
泰	tqve
纵	z/a
寄	jm;o
订	dbo
逻	ll/a
摘	zqe
侧	cxu
辞	cku
暴	bv/
祥	x;o
尾	wd/
洁	jdoo
唤	hci
摩	ml;
愈	yn;o
岂	qk/
孟	mb/
损	sse
韩	hfe
腾	thu
怨	yc;
愁	cl;
础	cje
洲	zoo
串	cc/
傻	sa
豪	hg;
健	jcui
苍	cpv
雾	wnv
奔	bw
哀	rq;
袭	xkv
抖	dle
睁	zyi
频	psi
乌	wu;
贴	tei
聊	lge
储	cju
旦	dc/a
逸	ym;a
吐	tji
旋	xfo
御	ynuu
傅	fnui
唇	csvu
珍	zwe
谷	gj;
荒	hpv
绕	rva
裂	lxvu
岸	rc/
潮	cgo
涌	yloo
墨	m//
搬	brei
搜	soei
艾	rqv
帐	zpi
耐	nqe
幅	fji
乘	ch;e
爬	pa;
什	skui
夺	dlv
尝	c;/o
掩	yfei
诺	n/o
貌	mvu
陶	tga
扎	zqei
羞	xo;
郎	l;oa
桥	qge
佳	jqui
姨	yka
戒	jxv
扭	nle
冥	mh;a
尺	ck/e
搞	gg
盟	mh/
拾	ske
摸	mo
夹	jqv
鞋	xdei
滑	haoo
媒	mda
碗	wfeu
详	x;oa
扯	cd
稿	ggu
枫	fyei
川	cr;
锁	slu
莉	lmvi
薄	blv
浓	nlo
恰	qq
糊	hjou
狱	ynua
聪	coei
奴	nja
骗	pca
肚	dnu
姊	zkau
矣	yk/o
倍	bxu
醉	zxe
甫	fjv
拖	toei
岳	yx;i
核	hde
殊	sueu
扶	fje
盖	gq;
盖	gd;u
烂	lcou
赖	lqe
彻	cxuu
浑	hso
冯	fh
邪	xdea
遭	ztv
痕	hs;
屈	qu/
仗	zpu
跃	yxia
凶	xo;o
巡	xs/
兼	jr;u
晋	jzvi
莱	lav
仲	z/ui
炎	yf;u
焰	yco
涂	tjo
瞪	dbi
弯	wr
嘻	xiia
悟	wnoo
潜	qfo
寿	s/v
沿	yfoo
膀	b;
坡	poe
悉	xi;o
季	jm;e
绪	xnaa
蛇	sdi
链	lcu
垂	cd;
冬	do;a
恭	gov
疼	th;e
郑	zbou
吞	tw
亭	th;e
乔	qg;
瘦	s/;e
踪	zoi
朗	l;oa
箱	xp;e
悠	yo;
斜	xdu
倾	qyu
祝	znoa
荪	swvi
仪	ykui
盗	dv;
羊	y;;u
嫁	jqau
讶	yqo
踏	tqi
池	ckoo
劲	jza
泛	fco
欺	qie
伍	wju
溜	lo
泥	nko
贼	zdia
吼	hli
懒	lfoo
占	zr/
脆	cxua
亏	kev
仔	zau
勉	mf;a
浅	qfoo
萨	sqv
惠	hxvi
韵	yzo
嗯	rwi
敲	qt
虫	cl/
埋	maei
玛	maee
悔	hdoo
庞	p;;
坦	tfe
恼	ngo
浩	hvo
拔	baei
阁	gd;i
凯	kai
辆	lpe
妮	ni
碧	bmve
搭	dqe
愣	lbo
泉	qf;i
融	rle
罩	zv/
郁	yneu
繁	ff;e
讯	xzoa
仆	pju
盾	dz;
洪	hloo
袍	pgo
婉	wfa
挨	rqe
阔	k/;
俊	jzu
茫	m;vi
纹	wsa
凑	c/o
晃	hp/
辉	heio
饰	smua
舅	j/;
甜	tfu
循	xsu
址	zkei
滴	dio
侵	qwu
焦	jt;
拦	lfei
款	kf
暖	nfi
惧	jno
遥	yg;
丫	yq;
播	boe
甘	grvi
障	zpa
璃	lkee
额	rdo
肃	sn/
卿	qyua
汇	hxo
艳	yce
奉	fbv
返	ff;u
拒	jne
辩	bco
屏	ph/
隆	lla
惹	rdvi
邻	lsuo
销	xtu
爽	s;v
涉	sxoo
劫	jde
霞	xa
咒	z//
缠	cfa
帽	mvi
帅	sqi
耀	yvi
廷	th;e
侍	smui
柱	zne
牧	mnu
添	tro
捉	zoe
脾	pku
牵	qrv
铜	tlu
袖	x/o
牢	lg;
驱	qua
堪	kre
挑	tt
忌	jm/
爹	de;
倘	t;ui
盯	dyi
截	jdvi
牲	syu
召	zv/u
迁	qr;
饿	rxu
央	yp/
餐	cr/e
塞	sq;o
措	c/e
企	qk;o
笼	ll;e
促	cnui
鹏	phua
矮	ra
霸	bqv
割	geo
衡	hhu
姚	yga
润	rzoo
扰	rg
辰	csvu
赌	dji
丛	cl;o
荷	hdv
庙	mv;
郭	goo
豫	ynao
瓦	wa
哲	zdvi
董	dlvi
港	g;o
锐	rxue
俄	rdu
吵	cgi
钧	jwu
渡	dno
竞	jb;
扔	ry
耗	hve
崇	cl/a
桃	tge
寸	cz
邦	bpe
喷	pw
琳	lsee
吕	lj/
赐	cmi
粮	l;ou
舌	sd;e
姿	zi;e
抚	fjei
愧	kxoo
脖	blu
迪	dk/
幼	y/a
染	rf;
闷	mw;
啸	xvi
吻	wsi
予	yj/
扫	sge
慈	ck;
玻	boee
佣	y/u
铺	puu
晕	yw/
嚷	r;
培	pde
稀	xiu
桂	gxe
玲	lhe
允	ys/
趁	czv
糟	zto
督	du
猪	zuu
臭	c/;
乙	yk//
籍	jk;e
悦	yxo
津	jwo
痴	ci;
侯	hlui
覆	fnv
屁	pm
媚	mxa
跪	gxi
井	jhve
熊	xl/
抛	pte
催	ceu
奸	jra
扮	bce
贤	xf/
嫌	xfau
衫	sro
乏	fa;
斩	zfe
咐	fni
瓜	gq;u
援	yfei
哎	rqia
酸	sre
夸	kqv
肥	fd
蒂	dmv
炸	zao
燃	rfo
嘉	jqvi
怖	bno
牺	xiue
欠	qc;
裁	cavi
爵	jd;
鹰	yy;
掏	tte
捕	bje
钢	gpu
柜	gxei
丑	cl/i
卧	w/e
磨	ml;e
湿	sioo
悬	xf/a
疲	pk;
宿	sn;
厨	cjvu
汤	tp
辱	rjv
贫	ps;
捧	phe
渊	yro
窝	wo
桑	sp/o
乖	gq;e
撑	cye
脏	zpua
勒	lxei
蛮	mf;e
惟	wdo
慎	szo
袁	yfvi
孝	xvv
躯	quu
屠	tj/
捏	ne
疾	jk;e
申	sw/
泽	zdo
航	h;u
晴	qhi
漠	m/o
勤	qse
狐	hju
坛	tfei
拼	pce
拼	pwe
剪	jf;u
宏	hl;o
扣	k/ei
租	zuue
耶	yee
裤	kno
翁	wy
赫	hxe
框	kpei
喘	cfi
瓶	phou
撤	cxe
遮	ze;
奖	j;;
祭	jm;a
卜	bj/
诱	y/o
喃	nfia
娃	waa
妥	tl;o
昌	cp/
昂	r;/
豆	d/v
巫	wuv
览	lf/
矛	mg/
扇	sc;a
歇	xei
档	dpe
桢	zwei
碍	rqeu
贺	hx/
堡	bg;i
洒	sao
铃	lhue
挡	d;e
弓	go/
泼	poo
凄	qio
祸	h/o
逢	fh;
耻	ckei
昭	zti
罚	fa/
宙	z/;o
卑	be;
逆	nm
盆	ps;o
呜	wui
喂	wxia
饮	ysua
驾	jq/u
陛	bma
咳	kd
寺	smvi
骤	z/aa
阅	yx;i
妨	f;au
绘	hxa
蜜	mm;
翔	x;ou
签	qr;e
审	ss;
齿	ck/e
盼	pci
霜	spv
廊	l;;e
岩	yf/a
汪	wpo
综	zoaa
栏	lfei
媳	xka
猎	lxu
雕	dtu
疏	sua
娶	qjv
侠	xau
炉	ljou
饱	bgua
戚	qivu
挖	wqe
泄	xxoo
赢	yh;e
魏	wxue
轩	xre
叛	pcou
叠	dd/
薇	wevi
匹	piv
贞	zw/
弥	mka
拨	boei
歪	wqv
鼠	sj;i
踢	ti
讽	fho
账	zpia
焉	yrv
陵	lha
漆	qioo
刑	xhee
耍	sav
帕	pqi
勾	go;a
盒	hd;o
芝	zivi
鉴	jc/i
腐	fj;e
慨	kao
赋	fnia
哟	yoi
寞	m/;
沟	gooo
谅	lpoa
披	pie
夕	xk;a
摔	sqe
愚	yj/a
宾	bw;
歉	qco
挽	wfei
吊	dv/
宅	za;
斥	cm;
裳	c;/o
灾	zq;
梯	tie
倩	qcu
贪	tr;
删	sru
亿	ymu
肤	fuu
植	zkei
姆	mja
币	bm;i
液	yxoo
叙	xnu
搁	geei
巾	jw/a
倦	jcui
谋	mlo
砍	kfe
滋	zio
刷	sqa
僵	jpu
柄	bh
锦	jsue
挣	zyei
钉	dyu
趟	tpv
秒	mgu
纱	sqaa
盈	yh/
胁	xdua
伪	wdui
崔	ce/
筋	jw;e
冤	yr;
腹	fnua
刃	rz/
糖	t;o
嘲	cgia
抑	yme
驻	zna
肖	xv/
匪	fdv
莹	yhvi
粒	lmo
麦	mqve
谣	ygo
呈	ch/a
绅	swaa
咕	gui
腔	qpu
辨	bcoe
撕	siei
砸	zae
奏	z/v
朴	pje
酷	kne
艰	jrao
卢	lj/e
纤	xra
册	cx;a
枯	kue
眨	zai
斋	zq;e
笨	bz
鞭	brei
劈	pi/
叉	cq/
绩	jmaa
掠	lxei
勃	blei
骄	jtaa
妞	no
摊	tre
谦	qro
姬	jiau
骚	sta
壶	hjv
裹	gl;
瞎	xqia
誉	yn;o
虹	hlia
溪	xio
柴	ca/
耸	sl;o
纠	joa
跌	dei
污	wuo
绸	cla
愉	yjoo
吩	fwi
斤	jw;u
饼	bhu
龄	lhi
贯	gc/
隶	lm/
涛	tto
励	lme
趋	quv
畏	wx/a
饶	rgu
辣	lqo
霍	h/vo
瑟	sxv
哇	wqi
桐	tlei
仓	cp;o
俱	jnu
帘	lf;o
樱	yye
昆	kw
卓	zl/
瞒	mfi
杭	h;e
霄	xtvo
翅	cmvi
磁	ckeu
役	ymuu
墓	mnvi
喉	hlia
萝	llv
恒	hho
雀	qx/
械	xxe
泡	pvo
骇	hqa
谨	jso
抄	cte
矿	kpeu
衍	yfu
闯	c;;i
辅	fjea
棍	gz
旺	wpi
珊	sree
缝	fba
眠	mfia
猴	hlua
菊	jjv
俏	qv
漏	l/oo
穴	xd;o
匠	jpv
跨	kqi
狮	siua
魄	p/u
迈	mqva
蓬	phv
埃	rqei
宴	yc;o
屑	xx/
邀	yt;
廉	lf;e
膝	xiua
契	qmv
嵌	qc/
揭	jee
蠢	csve
颈	jha
绳	sha
棋	qkei
鄙	bki
丧	spvi
填	tfei
棉	mfe
蝶	ddi
舟	zo;u
棒	bpei
冠	gr;a
鹤	hxoa
晌	s;i
筑	zj;
患	hc/
颠	dre
躬	gou
爪	za;u
艘	sou
邮	yli
署	sj/
债	zqu
劣	lx/u
捷	jdei
夷	ykv
巷	xpv
湾	wro
轿	jvea
枚	mdei
遂	sx;
绵	mfa
谎	h;o
誓	smvi
嫩	nz
渴	kdo
乳	rju
胞	btu
婴	yy/
诡	gdo
竖	sn/i
衰	sq;e
蒋	j;v
脉	mqu
脉	m/u
购	g/i
贾	jav
坟	fse
藤	thv
钻	zru
蕙	hxvi
违	wdv
戈	gev
筹	cl;e
裙	qso
寡	ga;
夭	yt;e
剥	boa
棵	kee
弦	xfae
惶	h;oo
婷	tha
恍	h;oo
寓	yn;o
绣	x/a
驳	bla
栗	lmvi
驰	cka
曹	cgvi
苗	mgv
膊	blua
譬	pm/
枕	zse
唉	rqia
杆	gfe
儒	rjui
蹲	dw
兮	xi;o
畅	cpia
赔	pdi
疗	lg;e
灌	gco
拆	cqei
堵	dje
顽	wfee
胳	geu
宠	cl;o
冻	d/oe
羡	xc;
押	yqe
舱	cpu
逝	smvi
揉	rlei
锅	goue
肌	jiua
搂	llei
拢	llei
肠	c;u
琪	qkee
兔	tn
恳	ks/
雇	gn;
悍	hcoo
酬	cle
梳	suei
弗	fj/
嗓	s;ia
嘱	zji
敦	dwo
遣	qf/
倚	ykui
姜	jp;
赴	fnvi
诀	jdoa
驶	skaa
妃	fea
晰	xiia
裸	lloa
哩	li
浴	yno
抹	mlei
氛	fw;
芸	ysv
腻	nmu
蔡	cqvi
淫	yso
鸭	yqi
浙	zxo
涯	yao
逗	d/vo
妄	wp;e
怯	qxo
筒	tl;e
刮	gqu
遵	zw;
逛	gp;
魅	mx;
祁	qkoa
蜂	fyia
湘	xpo
庸	yo;e
拘	jue
凰	h;;a
眯	mki
矢	sk;e
腊	lqu
眸	mli
旨	zk;
黛	dq;i
耽	drei
伐	fau
腕	wcu
甩	sa;
诧	cqo
凳	db/
汝	rjo
丘	qo;
贱	jci
穆	mnue
秃	tu;
漂	pto
躁	zvi
烛	zjou
杖	zpei
涵	hfo
俯	fjui
烁	s/o
贡	g/vi
坠	zx/
妓	jmau
坑	ky
陌	m/a
侄	zkui
篮	lf;e
沾	zro
钥	yvu
宰	za;o
楣	mdei
掀	xrei
妒	dna
玫	mdee
痒	y;;e
厢	xpvu
谱	pjo
滩	troo
狭	xaua
谊	ymoa
鼎	dh/
陀	tlai
蕾	ldv
掘	jdei
瑶	yge
侮	wjui
践	jcia
毅	ymoe
姻	ywau
僧	syui
叮	dyia
蕴	yzv
竭	jdoe
葬	zpvi
翰	hce
煤	mdo
鸦	yqea
裕	ynoa
崩	by/
撼	hcei
棺	gre
迭	dd;
泣	qmoo
灿	cco
拱	gle
溃	kxoo
殷	ywu
磕	keeu
粹	cxo
昔	xiv
斧	fj;o
苟	glv
阀	fa;i
侦	zwui
刹	cquo
哉	zqv
拐	gae
肆	sme
噢	roi
宛	wf;
堕	d//
沫	m/oo
愕	rxo
碑	beeu
摄	sxei
颊	jae
瞥	pe
噬	smi
铭	mhue
敷	fue
窜	cc;
啪	pqia
佟	tlui
笛	dk;
惭	cfoo
荆	jye
瑰	geee
倡	cpui
尬	gqv
糕	gto
尴	grvu
茵	ywv
携	xdei
棚	phei
渺	mgo
仑	ls;
郡	jzae
佑	y/ui
绮	qkaa
棠	t;/
咯	loi
衬	czo
偿	c;ui
鹿	ln;e
砖	zre
麟	lso
囊	n;v
饥	jiua
撇	pdei
售	s/;i
泊	blo
绑	b;a
暑	sj/a
蔽	bmvi
宪	xc;o
廓	k/;e
黯	rci
颂	s/u
浸	jzo
淋	lsoo
樊	ffv
窄	za;o
嗽	s/i
涩	sxoo
彭	phei
掷	zmei
卒	zj;e
蝎	xeia
暮	mnvi
莺	yyv
捐	jre
碌	lne
芙	fjvi
诵	s/oa
溢	ymoo
捣	dge
攀	prv
税	sxue
岭	lhia
崖	ya/
扁	bf;
斑	bree
淘	tgoo
兜	do;i
槐	hae
汹	xoo
疆	jpae
绒	rla
窃	qx;
婶	ssa
茅	mgvi
塌	tqe
株	zue
涨	z;o
憎	zyo
摧	cee
坊	fpe
歹	davu
诊	zsoa
踩	caia
巍	we/
匀	ys;
篷	ph;e
澡	zgo
隙	xmai
蓄	xnv
挪	nlei
辫	bcoe
桶	tlei
恕	sn/u
轨	gde
逊	xz/i
憾	hcoo
胎	tqu
稚	zmue
龟	ge;
咖	kqia
霓	nkv
乞	qk;e
缎	dcaa
兹	zi;u
嚣	xt/
栈	zcei
嘟	dui
喻	yni
胃	wx/a
昧	mxi
霉	mdv
鞠	juei
砰	py
捡	jfei
潘	pro
钩	goue
莎	sqvi
莎	sov
叨	dti
滨	bwo
惩	ch;u
弘	hlae
坎	kfei
娅	yqa
犬	qfv
歧	qki
哨	svi
豹	bvu
颓	tdue
罕	hf;a
啡	fei
缚	fnaa
肢	ziua
袜	wqo
蓦	m/vi
禅	cfoa
稽	jiue
襟	jwoa
韦	wdve
拂	fjei
谭	tfo
搅	jge
蚁	yki
怡	yko
藻	zgv
荫	ywvi
脊	jk;e
吏	lmvi
柏	baei
缕	lja
钞	ctu
弧	hja
枉	w;e
雯	wsv
芦	ljv
腥	xyu
薪	xwv
晒	sqia
嗡	wyi
粘	zrou
靖	jboe
筷	kq;
娱	yjau
凸	tu/
嫣	yra
怔	zyoo
衙	yau
衔	xfu
逍	xt/o
橘	jje
屡	lj/e
馨	xwvi
妆	zpoe
衷	zo;e
兆	zvu
硕	s/eu
簇	cn;
郊	jto
岚	lf/a
菩	pjv
岗	g;/
莽	m;vi
寨	zq;o
盏	zfv
嘶	siia
褂	gqoa
呻	swi
赠	zbi
焕	hcou
薛	xev
啼	tki
朕	zzua
圾	jie
琐	sle
烤	kgo
滞	zmoo
诞	dcoa
骆	l/aa
暇	xai
桩	zpei
蓉	rlvi
罐	gcu
迦	jq/u
钦	qwue
锣	llu
菱	lhvi
辽	lg/
噪	zvia
辕	yfea
舜	sz;
陋	l/ai
勿	wn;a
毙	bmva
帧	zwi
狡	jgu
沸	fxo
撒	sqei
盐	yfvi
柯	keei
凛	lsoe
嫉	jkau
筝	zy;
烫	tp;
搏	blei
轴	zle
斌	bwoe
嗤	cii
蔑	mxvi
驼	tlaa
骷	kui
徽	heu
浏	lloo
霆	thvo
脂	ziua
祷	dgo
呃	rxi
艇	thuu
咪	mi
尉	ynae
呕	rli
髅	lli
沐	mno
焚	fsv
辜	guv
尹	ys/e
哄	hoi
潇	xto
祈	qkoa
踱	dli
弊	bm;u
傩	nlu
榜	b;e
颖	yhu
邓	dba
喧	xri
咦	ykia
匙	ck/a
噗	pui
惘	w;o
狸	lku
剖	pooe
胧	llua
坤	kwe
梭	soei
磊	ldvu
煌	h;ou
趴	pqia
锤	cdu
妾	qx;e
溅	jcoo
搀	cre
娥	rda
葛	gdvi
擎	qhv
狄	dkua
膛	t;ua
镖	btue
朦	mhua
驴	ljaa
盔	kevu
嗦	soi
寇	k/;o
肿	zlu
盲	m;;
滔	ttoo
囚	ql/
拣	jfei
僻	pmu
琼	qlee
蹈	dgi
熙	xivi
玖	jle
璐	lnee
煮	zjvi
滤	lno
虞	yj/e
珑	llee
旷	kpi
佐	zlui
灼	zlo
潭	tfoo
嚼	jgi
栽	zqvi
傍	bpu
渔	yjoo
窟	ku;
贩	fci
虐	nx/
弩	nj/u
碟	dde
娴	xfau
俘	fjui
陡	dla
丸	wf;a
擅	scei
匣	xav
婿	xnau
雁	ycvu
窘	jl;o
虏	lj/e
秩	zmue
恂	xsoo
鸽	geuo
拓	tqei
拓	t/e
唧	jii
巢	cg/
瑾	jse
姥	lga
肺	fxu
诈	zqo
祺	qkoa
绽	zca
梨	lk;e
捂	wje
嘀	dki
蜀	sj/a
萍	phvi
梢	ste
蝇	yhi
蒸	zyv
沌	dzo
缀	zxa
瞻	zri
瓷	ck;e
楞	lhei
絮	xn/
戮	lnao
顷	qhe
梵	fcvi
兀	wnvu
绢	jca
寝	qs;
堤	die
敞	c;i
蛙	wqia
咸	xfv
亩	mj;
沧	cpo
帆	fri
瑜	yje
僚	lgu
赚	zci
岔	cq;
窥	ke;
捆	kse
伞	sf;
邱	qou
咚	doi
杏	xbvi
墅	sn/a
垫	dcv
沃	w/o
狞	nhu
瞳	tli
鹅	rdue
谐	xdo
熬	rgv
醋	cne
塑	sn;u
俞	yj;o
嘎	gai
诅	zjoa
澜	lfoo
煞	sq;a
栋	d/e
彬	bwe
黎	lk;e
削	xti
削	xeio
履	lj/e
胀	zpua
讥	jioa
嗔	cwi
咙	llia
榻	tqei
纽	nla
烘	hoo
憋	be;u
锡	xiue
箫	xt;
荐	jcv
麒	qkoe
眷	jc;u
卸	xxu
蹦	bbi
钮	nlue
稻	dvu
朽	xle
峡	xaia
蹄	tkia
庚	gy
蜡	lqia
淹	yroo
腮	squ
斟	zwei
捞	lt
缸	gpue
奢	sev
唔	wji
殖	zkeu
魁	kd;
咽	yri
咽	yxia
阮	rfa
阎	yf;i
撰	zcei
挠	nge
绰	c/a
擒	qsei
哑	yqia
丐	gqvi
鳞	lsua
垒	ld/
毯	tf;
廖	lv;
嗜	smia
冗	rl;
狈	bxua
锻	dcue
讳	hxoa
铠	kau
蛛	zui
寥	lg;o
肝	gru
孽	nxv
汁	zioo
蝴	hji
抿	mse
耿	gh
裴	pd/
叭	bqia
聘	pz
贸	mv;a
塘	t;e
厮	siv
徊	hau
讪	sco
蚀	skua
茹	rjvi
啥	sai
闺	ge;i
唾	t/i
琢	zlee
琉	llee
铨	qfue
蕊	rdvi
禀	bh;
炽	cmo
踌	cli
剂	jmoe
葡	pjvi
乍	zq;e
翘	qvv
伺	cmu
揪	joe
袄	rgo
嚎	hgi
炒	cgou
庵	rr;
睹	djia
萄	tgv
茂	mvv
哮	xtia
嘘	xui
摹	mlvi
芽	yavi
跋	bai
尧	ygv
炭	tc/
渗	szoo
禽	qs;o
瞄	mgi
鲍	bvua
叩	k/i
酱	jp;e
浆	jp;e
搓	coei
壳	kdv
壳	qvvi
伶	lhui
枣	zgvi
浦	pjoo
郝	hge
厦	sqvu
届	jx/
宵	xt;o
膜	mlu
拙	zoei
滥	lcoo
坪	phei
哆	doia
禄	lnoa
咧	le
炕	kpo
揍	z/e
哗	hqia
沦	lsoo
扛	k;e
檐	yfei
绞	jga
挚	zmvi
敖	rge
镶	xpu
嗅	x/i
瓣	bcoe
怅	cpoo
畜	cn;e
噜	lu
粥	zoae
匕	bk;a
躇	cji
蚊	wsia
遁	dz;u
屯	ts
浇	jtoo
淮	haoo
耕	gye
葱	cov
徘	pauu
卦	gqei
戳	coa
霖	lsv
揩	kqei
熄	xiou
阈	yn;i
慷	kpoo
廿	ncv
悯	mso
蔼	rav
蒲	pjvi
畔	pcia
猾	haua
蚂	mai
丞	ch/i
瘾	ys;e
彦	yc;e
膏	gt;
虾	xqia
咆	pgi
纲	gpa
铸	znu
忿	fz;
萱	xrv
窍	qv;
诬	wuoa
懊	rvo
剔	tii
旱	hc/a
绯	feaa
婢	bmau
钓	dvue
雍	yo;e
峻	jzi
掐	qqe
铅	qru
燥	zvo
祀	smoa
揣	cqei
侣	lju
璧	bm/e
敛	lfu
翩	proa
倭	wou
簿	bn;
萌	mhvi
悼	dvo
眩	xci
辟	bmae
彪	bt/
熏	xw;e
浊	zloo
祟	sx/i
谬	m/oa
啧	zdia
眶	kpia
俨	yfui
庶	sn;e
喀	kqia
漾	ypo
灶	zvou
俺	rfu
庐	lj;
聂	nxvi
觅	mm;o
阱	jhai
戟	jkei
懦	n/oo
胶	jtu
殆	dqeu
芯	xwvi
挫	c/ei
妍	yfau
橱	cjei
蟹	xx;
阐	cf;i
孕	yz/
颐	ykei
屉	tm/
瞅	clia
襄	xp;e
骸	hai
棱	lhei
冀	jm/e
竿	gr;e
葫	hjvi
禹	yj;i
咏	ylia
肘	zlua
痰	tf;e
拴	srei
昼	z//e
迸	bb;u
桓	hfei
凹	rt
栅	srei
梧	wjei
瘫	tr;e
捶	cde
诛	zuoa
冉	rf/
茄	qdv
珂	keee
扳	brei
螺	llia
滢	yho
酿	np
沅	yfoo
揽	lfei
旭	xn;
剃	tmo
哧	ciia
韧	rze
怠	dq/o
丙	bhv
疤	bq;e
蝉	cfia
溯	snoo
帜	zmi
贮	znia
谜	mko
儡	ldu
勋	xwi
揖	yie
茜	qcv
叽	jiia
侃	kfu
尿	nv/
喳	cqi
搔	stei
拇	mje
惚	huo
驯	xza
聋	llvu
颅	lji
嗨	hqia
瞟	pgia
泻	xxoo
洽	qqo
绥	sdaa
祠	ckoa
呸	pei
涕	tmoo
悴	cxoo
呐	nqi
榴	llei
涅	nxo
叱	cmia
馈	kxu
淌	t;oo
跺	d/i
鹃	jri
惕	tmoo
彤	tlua
仇	qlu
嘈	cgia
筐	kp;e
藩	frv
苑	ycvi
旬	xs;
酌	zlei
觑	qni
厥	jdvu
琦	qkee
亥	hq;e
嬉	xia
舆	yj;i
瑚	hje
塞	sx;o
惫	bx;
秽	hxu
漓	lkoo
昊	hv/
镯	zlue
拭	smei
甸	dc;a
垃	lqei
垃	lxei
沪	hno
弛	ckae
酥	suei
铲	cfue
绊	bca
臀	ts/
棘	jkei
钊	ztu
抒	suei
匿	nmv
敝	bmo
唬	hjia
薄	bgv
髦	mgvi
蝠	fjia
斐	fd/
龚	govu
亨	hy;
拷	kge
囡	nr
憔	qgoo
钰	ynue
樵	qgei
蔚	wxvi
秉	bh;e
鬟	hfv
懈	xxoo
澈	cxoo
赘	zxv
侨	qgu
歼	jreu
蛊	gj/a
倏	suui
煎	jr;u
苛	kevi
娟	jrau
晦	hxi
厕	cxv
疙	ge;e
靴	xee
虔	qf/e
吱	zii
畴	clia
梗	ghe
舔	tfue
晖	heia
歆	xwoe
珏	jdee
芭	bqvi
邵	sva
蕉	jtv
檀	tfei
蚕	cfv
仄	zxvu
吁	xuia
泳	yloo
芷	zkvi
札	zaei
蜘	ziia
疫	ym;e
淳	csoo
冶	ydo
症	zy;e
翎	lhuo
咨	zi;e
猿	yfua
霎	sqvo
隋	sdai
粪	fz;u
甭	bhvu
飙	bteu
吆	yti
惋	wfo
汀	tyo
沛	pxo
砌	qme
炫	xco
蚩	ci/
钝	dzu
惦	dcoo
奚	xi;o
犀	xi/
喇	lqia
韬	ttee
噩	rxvi
拌	bcei
氓	m;o
氓	mho
偎	weu
楠	nfe
冈	gp/
鬓	bzv
溶	rlo
笃	dj;
婪	lfvi
辙	zdea
慑	sxoo
瀚	hcoo
璇	xfe
疚	j/;e
菁	jyv
砂	sqeu
绎	yma
窑	yg;o
袱	fjoa
沮	jjo
巩	glei
蛟	jti
阑	lf;i
妩	wja
狰	zyua
窒	zm;o
鞘	qve
绫	lhaa
兢	jyei
壤	r;e
嗳	rai
牡	mju
囔	npi
惮	dcoo
墟	xue
攘	r;ei
沁	qz
缄	jraa
募	mnvi
啃	ksi
霹	pivo
澳	rvoo
肋	lxua
砚	yceu
贬	bfi
匈	xo;a
憨	hr/
棕	zoei
倪	nku
槽	cge
狙	juu
苹	psv
馒	mfu
膨	phua
拎	lw
矗	cnv
崭	zf/
栖	qiei
炯	jlou
猩	xyua
厄	rxvu
奎	kdvu
坝	bqe
渣	zqoo
撅	jeei
糙	cto
倔	jdui
忖	csoo
兑	dx;
卵	lfua
缴	jgaa
褪	tz
榆	yjei
曳	yx/a
漱	snoo
雳	lmvo
朔	s/ou
赎	sji
屎	sk/e
蹭	cb
溺	nmo
睬	caia
捻	nfei
棣	dme
苇	wdvi
蹬	dbia
吝	lz;
挟	jqe
笙	sy;e
垮	kae
亢	kp;e
扒	bqei
踹	cqia
峙	zmia
侥	jgui
省	xh/
篱	lk;e
逞	ch/a
漩	xfoo
髓	sdia
仔	zkui
峭	qvi
桨	j;;e
笺	jr;e
俭	jfu
蹋	tqia
巅	dr/
稣	suua
喽	llia
陨	ysai
勺	sg;
峨	rdi
铮	zyue
择	zaei
幢	zpia
曙	sjia
撮	coei
穹	ql;o
罡	gp/a
汰	tqo
矜	jwa
筛	sq;e
帖	teia
穗	sxue
锥	zeu
刁	dt/
枢	suei
拽	zqei
瀑	pn
涡	gooo
涡	woo
彷	f;uu
隅	yjai
皂	zv;i
瘪	bd;
吠	fxi
烙	lvo
舵	d/u
沼	zgoo
诏	zvoa
憧	coo
辖	xae
崎	qkia
邹	zoua
黝	ylia
袅	ng;a
恬	tfoo
鸳	yr;a
藉	jkvi
璋	zpee
眺	tvi
胭	yru
湛	zcoo
憬	jho
驭	ynaa
咻	xoi
奕	ym;e
闸	za;i
煽	srou
哽	ghi
椒	jte
琅	l;e
炙	zm;a
镰	lfue
浒	hjoo
褥	rno
靶	baei
柿	smei
髻	jmv
赦	sxei
睫	jdi
蹙	cnvu
牟	ml/
陕	sfa
毋	wj/a
壕	hgei
佬	lgui
熹	xivi
侈	ckui
衅	xzu
塾	sj;e
冕	mf/
茸	rlvi
盅	zo/a
瑛	yyee
漪	yio
稼	jque
肮	rp
簌	sn;e
嗖	soia
酣	hre
拯	zhe
盂	yjve
骡	llaa
妲	daa
翡	fd/e
瘩	da;e
蔓	mfv
荀	xsv
券	qc;u
蝙	bri
鸯	yp/a
窿	ll;o
谍	ddo
炳	bho
亵	xx;e
寅	ys;o
厘	lkvu
殉	xze
啐	cxi
碾	nfeu
仕	smui
炀	y;ou
裔	ym;e
姗	sra
芜	wjvi
庇	bm;e
玺	xk;a
奠	dc;u
蠕	rji
缭	lgaa
疮	cp;e
涎	xfoo
娼	cpa
逾	yj;o
榕	rlei
癸	gd/
涣	hcoo
邸	dkua
睿	rx/
饺	jgua
皓	hvu
忏	ccoo
隧	sxa
孰	sjo
惺	xyo
晏	yc/
滕	thua
谛	dmo
螃	p;i
杉	srei
绷	bya
桔	jdei
捅	tlei
缆	lfa
铎	dlue
晤	wni
澎	phoo
佘	sd;o
匾	bfv
熔	rlou
逮	da/
婕	jdau
谕	ynoa
颁	bruo
毡	zr;
彰	zpoe
骏	jzaa
咂	zqi
茧	jfv
殴	roe
涟	lfoo
撩	lgei
脯	pjua
嗣	smia
雏	cjua
蒜	scv
嵇	jiue
娄	ll;u
琛	cwee
捺	nqei
馋	cfua
俐	lmui
伽	jqui
褐	hxoa
镑	bpue
崽	za/
鹫	j/;e
鹦	yyi
叼	dtia
詹	zr;a
恃	smoo
磅	bpeu
胤	yzua
锄	cjue
茉	m/vi
遏	rx/a
悚	slo
睨	nmi
蜷	qfi
瘟	ww;
暧	rqia
篓	ll;e
芊	qrvi
蛰	zdvi
饷	x;u
渠	jn;o
澄	choo
呱	guia
烹	py;
茨	ckv
蟒	m;i
屿	yji
暄	xria
辄	zdea
俟	smui
宦	hc;
驹	jua
锢	gnu
迢	tg/
噎	yei
蔷	q;v
萤	yhvi
裘	qlv
扼	rxei
辐	fjea
潺	cfoo
窦	d/;o
悖	bxo
褒	bt;
眈	dri
驿	ymaa
烬	jzou
匡	kpv
嗒	tqia
瑕	xaee
绚	xcaa
贷	dq;i
箍	gu;
咄	doia
啤	pki
炊	ceo
簧	h;;e
懿	ymei
喔	roia
殡	bze
沏	qioo
湃	pqoo
癖	pk;e
傀	geui
悸	jmoo
咋	zaia
辗	nfea
诫	jxo
籁	lq;
鞍	rre
徨	h;uu
迂	yu
飕	so;
靡	mk;e
愫	snoo
熠	ymou
瓢	pge
欤	yjea
盹	ds
吨	dwi
巳	sm/
殃	ype
腆	tfua
谑	xxoa
孜	ziai
吮	ssi
贿	hxia
掺	crei
惆	clo
噤	jzia
笋	ss;e
粱	l;;o
鸾	lf;e
榨	zqei
橙	chei
唠	lgi
恺	kaoo
嫦	c;a
咎	j/;a
渍	zmoo
蹂	rlia
诃	heoa
鲸	jyu
墩	dwe
啄	zlia
恙	yp;
蔬	suvi
昵	nmia
缨	yya
矫	jgue
橡	xpei
戬	jfei
薯	sjv
趾	zki
坍	trei
钗	cque
桦	hqei
焱	yc;u
秤	cbu
椭	tlei
嗷	rgi
痞	pk;e
稷	jmu
躏	lzi
萦	yhvi
醇	cse
恤	xno
纺	f;aa
嫖	pga
羲	xi;u
窖	jv;
癞	lq;e
剿	cta
剿	jgaa
凋	dto
稠	clu
埠	bne
钵	bou
锵	qpue
咀	jji
袒	tfoa
炬	jnou
葵	kdvi
踞	jnia
桀	jd;a
勘	krei
枷	jqei
鹉	wjee
雌	cki
萎	wevi
缔	dma
缅	mfaa
偌	r/u
驸	fnaa
颔	hcu
婊	bga
酋	ql;u
舐	smue
惴	zxoo
麾	he;
惰	d/oo
筵	yf;e
孺	rja
谴	qfoa
貂	dtuo
洼	wqoo
攥	zcei
帷	wdia
枭	xt;a
羁	ji/
咔	kaia
蹑	nxi
涧	jcoo
梆	bpei
磋	coeu
睦	mni
馅	xcu
赁	lz;i
胥	xu/i
舫	f;uu
玑	jiee
烽	fyo
礁	jteu
佯	y;ui
垢	g/ei
狩	s/ua
汲	jko
迄	qm;e
擂	lde
帚	zl/e
谤	bpo
悻	xbo
腑	fjua
怦	pyo
忑	txv
渝	yjoo
肴	yg;o
羿	ym/o
娲	wqa
搐	cnei
猥	wdua
聆	lhei
煜	ynou
禾	hd;e
闽	ms;
忐	tf/e
赃	zpia
诲	hxoa
猝	cnua
羹	gy;
紊	ws;e
冢	zl;a
蹿	cri
幔	mci
戾	lm;a
潦	lgo
藕	rlvi
魇	yfvu
缥	pta
掂	drei
锈	x/u
鸠	jou
猖	cpua
舷	xfuu
戊	wnvu
薰	xwvi
菇	guvi
哝	nli
撵	nfei
幡	fria
啬	sxvi
痹	bm;e
麓	lnvi
戎	rlva
渎	djo
甄	zwei
琶	pav
骰	tlia
桅	wde
腼	mfua
祯	zwo
幌	h;i
纣	z/aa
饲	smua
偕	xdui
垣	yfei
涤	dko
栩	xje
诩	xjo
芥	jxvi
骼	gdi
癫	dr;e
唆	soia
汩	gjo
蜒	yfi
喋	ddia
鹊	qxe
琵	pkv
鲨	sq;o
皙	xivi
谚	ycoa
屹	ymi
缜	zsa
瓮	wb
垄	llvu
崆	koi
缈	mga
唰	sqia
邃	sx;o
畸	jiia
邑	ym/a
攒	cfei
攒	zfei
忡	cooo
跷	qti
掣	cx;e
苞	btv
葆	bgvi
膳	scu
呛	qpi
卤	lj/e
拧	nhe
耦	rlee
坳	rve
秧	ypu
孚	fj;o
篆	zc;e
寐	mx;o
缉	jiaa
伎	jmui
隘	rqai
甥	syue
跄	qpia
踉	l;i
凿	zg/i
凿	z//i
卉	hxvi
坞	wne
沥	lmoo
呷	xqia
楷	jeei
楷	kaei
蘸	zcvi
嵩	so/
毗	pkia
粟	snvi
隍	h;a
蕃	ffvi
哒	dqi
颉	jdei
啷	lpi
鼾	hru
栓	srei
酉	ylvi
骋	cha
睽	kdi
砾	lmeu
藐	mgvi
纨	wfaa
毓	ynue
璀	cdee
啰	loia
腋	yxu
阜	fn;i
泓	hloo
鸥	roea
卯	mgua
衮	gs;
簪	zr;e
羔	gt;u
糜	md;
飓	jn;a
劭	svau
杠	gpe
佃	dcui
铿	kyu
璨	cce
龊	c/i
掳	lje
犄	jiue
饵	rdua
镔	bwu
圃	pj/
龌	w/i
谄	cfoa
壑	hx/e
邢	xhee
绉	z/aa
惬	qxoo
绛	jpaa
臧	zpvu
蜕	txi
酝	yze
蜿	wri
煦	xn/a
菌	jwv
遐	xa/
镣	lvu
粤	yx;i
冽	lxoe
啾	joi
蜥	xiia
缰	jpaa
豚	tsu
璞	pjee
禧	xkoa
靳	jze
壬	rs;
皎	jgui
卅	sqvu
拄	zje
殓	lce
姣	jtau
龛	kr;o
霏	fevo
忱	csoo
蜻	qyi
丕	pivu
扈	hn;
啜	c/ia
碴	caeu
钳	qfue
笠	lm;e
筏	fa;e
粽	z/o
庠	x;;e
掸	dfe
翱	rgui
娜	nlau
撂	lve
讷	nxoa
诣	ymoa
谏	jcoa
讹	rdoa
贻	ykia
帛	bl;
恻	cxoo
黔	qfia
娓	wdau
纂	zf;
驮	tlaa
攫	jdei
蘑	mlvi
阖	hd;i
蛐	qui
饯	jcua
臻	zwea
亘	gzv
苔	tqvi
蝗	h;ia
咫	zk/e
蛾	rdia
渲	xcoo
纬	wdaa
馁	nd
瞌	keia
篡	cc;e
醺	xwe
谒	yxoa
昕	xwia
汶	wzo
椎	zee
屐	ji/e
茬	cavi
瀛	yhoo
鹭	ln/a
霭	ravo
飒	sqoe
恣	zm;e
漉	lnoo
豁	haoo
曦	xiia
胯	kqu
痊	qf;e
捎	stei
唏	xiia
瘸	qd;
戌	xuv
楫	jkei
搪	t;ei
磐	pf;
昱	yn/a
螂	l;ia
梓	zkei
瞿	qj/a
犁	lk;e
嫡	dka
鄂	rxia
豺	cauo
珀	p/e
隼	ss;i
蜓	thi
茗	mhvi
踵	zlia
晾	lpia
锯	juue
彝	yk/a
瘴	zp;e
嚏	tmi
吭	h;ia
吭	kyi
瞩	zjia
懵	mhoo
鹳	gce
峦	lf;e
瞠	cyi
娣	dmau
锚	mgue
掇	doe
崛	jdia
谟	mloa
傧	bwui
黏	nfu
硝	xte
陇	llai
饽	boua
蟾	cfia
怂	sl;o
胄	z//a
獠	lgua
沓	tq/
筠	ys;e
乓	pp;
跤	jtia
岌	jk/a
弁	bc/o
濂	lfoo
睇	dmi
骈	pfa
叟	sl;i
掰	bque
岱	dq;i
蟀	sqia
颍	yhua
铐	kvu
呓	ymia
偃	yfui
咿	yii
玳	dqee
舶	bluu
镌	jru
闵	ms;i
荔	lmvi
攸	you
慵	yooo
蹊	xiia
忸	nloo
谀	yjoa
萃	cxvi
赂	lni
讼	s/oa
槛	jce
槛	kfei
怩	nkoo
瘁	cx;e
贰	rxva
淞	soo
懋	mvvi
瞰	kc
肇	zv;a
奄	yrvu
嘭	pyi
唷	yoia
噼	pii
剌	lae
扉	fe;
瞑	mhia
抡	lwe
倌	grui
拈	nre
杞	qkei
烨	yxou
佗	tlui
喏	rdia
霁	jmvo
锭	dbu
邬	wuu
熵	spo
媛	yfau
膺	yy;e
沽	guo
舀	yg;o
嚓	cqia
搽	caei
羌	qp;
殇	spe
诘	jdoa
挛	lf;e
囱	co;i
鳄	rxua
孵	fuua
娉	pya
苓	lhvi
痪	hc;e
俸	fbu
颦	ps/
淀	dcoo
逵	kdvi
噔	dyia
乒	py;i
岑	cs/a
嵋	mdi
耷	dqvu
侏	zuui
骁	xta
腴	yju
镂	l/u
赳	jov
阙	qe;
佼	jgui
蛆	quia
祢	mkoa
淤	yuo
氧	y;;e
溟	mhoo
箕	ji;
鞑	dae
聿	yn/e
镀	dnue
簸	bl;e
诽	fdo
暨	jm/e
噘	jei
椰	yeei
琥	hjee
腌	yrua
杳	ygvi
阉	yr;i
柬	jfvi
夙	sn;a
痘	d/;e
鲤	lkua
俾	bkui
揿	qze
蜗	woi
媲	pma
虬	qli
戍	snvu
荧	yhvi
擞	slei
纶	lsa
蟋	xiia
蜈	wjia
箩	ll;e
蚣	goi
涸	hdoo
橹	ljei
臭	x/;
茎	jyvi
嘁	qii
宿	xl;
嚅	rjia
豢	hc;u
疵	ci;e
恿	yl/o
遽	jn/e
榭	xxei
缤	bwa
韶	sgo
鳌	rgve
迥	jl/
憩	qm;e
蛤	gdia
蛤	haia
黠	xaia
槌	cdei
闩	sr;
拗	rvei
拗	n/e
赊	sei
篙	gt;e
杵	cjei
沂	ykoo
芍	sgv
粲	cc/e
渭	wxoo
阂	hd;i
赈	zzi
宓	mm;o
甬	tl/o
瑙	ngee
宕	dp;
蓓	bxv
蜴	ymia
瑁	mve
虱	si/u
侬	nlui
伫	znui
嘹	lgia
罔	w;/a
娑	so;o
槟	bwei
嗫	nxia
闰	rz;
缪	mva
缪	mla
圳	zzei
怆	cpoo
髯	rfv
窈	yg;o
痉	jb;e
哺	bji
蔗	zxvi
曝	pni
耘	yse
喵	mti
斓	lfoe
喟	kxi
呦	yoia
炖	dzou
嘤	yyia
昙	tf/a
岐	qkia
汴	bcoo
戛	javu
荼	tjvi
嗥	hgia
胚	peu
褚	cjo
匝	zqva
诌	zooa
笆	bq;e
蟠	pfi
咛	nhi
裱	bgo
曜	yvia
噫	yiia
氅	c;/o
溥	pjoo
弑	smuo
掬	juei
垦	ks/e
窠	ke;o
茁	zlvi
淆	xgo
芹	qsvi
诳	k;o
泞	nb
筱	xg;
篝	go;e
卜	bo/
劾	hdoe
剁	d/ua
岖	quia
恸	t/o
旌	jyoe
盎	rp/
桧	gxei
抠	koe
臊	stua
刍	cj;
罅	xqu
淇	qkoo
蜃	szv
鑫	xw;o
忒	txva
璜	h;ee
跚	sri
蹩	bd;u
洵	xsoo
轶	ymea
濡	rjoo
磷	lseu
蟆	maia
娆	rga
窕	tg;o
孑	jd/
堡	pn;
榄	lfei
寰	hf;o
硫	lleu
泯	msoo
徙	xku
婀	re
濒	bwoo
衾	qw;
匍	pj;
潼	tlo
滇	droo
瑭	t;ee
颧	qfei
悒	ymoo
踊	ylia
闾	lj;i
嗟	jeia
嗟	jeia
臆	ymua
咳	hqia
嗝	gdia
轧	gaea
踝	haia
玷	dcee
溉	gqoo
痨	lg;e
峥	zyia
旎	nkoe
瘠	jk;e
臃	youa
褛	ljoa
谆	zwoa
抉	jdei
斫	zleu
怏	ypoo
邯	hfei
诙	heoa
靥	yxvu
蹒	pfia
褴	lfoa
涔	csoo
荤	hwv
柏	blei
谥	smoa
柩	j/ei
橄	gfei
滓	zko
鸨	bgua
赭	zdei
衲	nqo
剐	gaia
粼	lsou
粘	nfo
撬	qvei
纾	suaa
啻	cm;e
诒	ykoa
牍	djui
泌	mmo
玮	wdee
釜	fj;o
堰	ycei
泠	lhoo
嗑	kxia
谧	mmoa
诿	wdoa
剽	ptei
讴	roo
橐	tlv
鳅	qoua
痢	lm;e
绺	llaa
啕	tgi
畦	qkia
芋	ynv
涮	scoo
胴	d/ua
荃	qfvi
礴	bleu
皿	ms/a
郢	yhia
顼	xuee
蚯	qoi
诮	qvo
糯	n/ou
聒	goei
弼	bmae
鲲	kwu
轼	smea
竺	dj;e
堑	qcva
蚓	ysia
诨	hzoa
炜	wdou
啮	nxia
圭	gevi
淼	mg/a
旖	ykoe
鹂	lkei
辘	lnea
袂	mxo
弈	ym;e
癌	ra;
谪	zdoa
庖	pg;
鹞	yvuo
笈	jk;e
嵘	rlia
哔	bmi
怄	r/o
肾	sz/
匐	fj;a
乩	jiie
脐	qku
坷	kde
皋	gt;i
哂	ssia
蚪	dlia
霾	mav
糠	kpou
泸	ljoo
雹	bgvo
眦	zmia
铛	cyu
铛	dpu
涓	jro
胰	ykua
涿	zooo
焊	hcou
莘	swvi
莘	xwvi
锹	qtu
敕	cme
饬	cmua
翌	ym/o
诋	dkoa
珞	l/e
氢	qy;
饨	tsua
婧	jba
缇	tka
诠	qfoa
坯	piei
俑	ylui
嚼	jdia
俚	lkui
茱	zuv
雉	zmue
蚤	zg/o
佻	ttu
恪	kxoo
浣	hcoo
馄	hsua
芮	rxvi
樟	zpei
矶	jieu
辍	c/ea
犊	djue
魑	ci;i
娌	lka
姥	mjau
蚱	zqia
骊	lkaa
猬	wxua
迩	rd;a
蝌	keia
辎	ziea
豕	skvu
殒	yseu
妯	zla
珈	jqee
菠	bov
雀	qg/
搡	s;e
骠	bta
箸	zn;
碉	dte
槁	gge
佥	qr;o
裆	dpo
蔻	k/v
遑	h;;i
饕	tt/
懑	mz
柢	dkei
嬷	mqa
淙	cloo
嗬	heia
揄	yjei
恫	d/oo
卞	bc;e
挎	kqei
猢	hjua
淅	xioo
蹶	jdia
孪	lf;e
鳖	be;u
怵	cno
瘤	ll;e
佚	ymui
泱	ypoo
钏	ccu
幛	zpia
螳	t;i
骥	jmaa
馍	mlua
刽	gxu
刨	bvua
氲	yw;e
绔	kna
郜	gvu
挲	so;o
兖	yf;e
诟	g/o
脓	nlua
睐	lqia
皑	rau
鸢	yrva
燮	xx;e
莓	mdvi
淬	cxoo
孀	spau
侩	kqui
讣	fno
爪	zg;
鲫	jmua
隽	jz;i
狲	swua
垠	ysei
楮	cjei
琏	lfee
嬴	yh;e
晔	yxia
俪	lmui
汕	scoo
邺	yxii
斡	w/ei
壹	yivi
犷	g;u
鹑	csoe
锏	jfue
瓒	zcee
蛀	znia
滂	ppo
蚌	bpi
蚌	bbia
贾	gjv
琨	kwee
蹇	jf;o
摒	bbe
馥	fnue
衢	qju
觞	spua
臼	j/;i
剥	btae
渤	bloo
垛	dlei
餮	txvu
咣	gpia
邋	lq/
臾	yj;i
淖	nvo
遢	tq/a
钹	blue
氤	yw;e
鬃	zov
皖	wfu
椽	cfei
牯	gjue
翟	dk/o
翟	za/o
跛	bli
燎	lgou
诶	reo
宸	cs;
纭	ysaa
佞	nbu
痣	zm;e
姘	pwa
褶	xkoa
褶	zdoa
湮	yroo
湮	ywo
靼	daei
噶	gaia
妪	ynau
绾	wfaa
扪	msei
瓯	roea
榷	qxei
檬	mhe
迳	jb/
呶	ngi
伧	cpui
伢	yaui
幂	mm;a
缙	jzaa
梏	gnei
掖	yeei
彗	hxve
魍	w;;i
浃	jqo
铡	zaue
婵	cfau
赡	sci
忤	wjo
鸷	zmvi
碳	tceu
柚	y/e
颌	hduo
渥	w/oo
挞	tqei
蝼	llia
掮	qfei
讫	qmoa
翳	ymva
邕	yo/a
喁	ylia
喙	hxia
罄	qbv
煨	weo
颀	qkuu
嶙	lsia
泅	qlo
咝	siia
蒿	ht
蟑	zpia
鬈	qfvi
獭	tau
厦	xqvu
祗	zioa
辇	nfve
皈	geui
俎	zjuo
捋	loe
猷	ylou
龇	ziie
裟	sq;o
耄	mvvi
笞	ci;e
谙	rro
潞	lnoo
箧	qx;e
酪	lvei
揶	yde
袈	jq/u
靓	jbee
隗	wdai
濠	hgo
缮	sca
阕	qx;i
琰	yfee
晁	cg/a
呗	bqia
呗	bei
荟	hxvi
骜	rvv
峋	xsi
砥	dkeu
鹄	gjue
夔	kd;u
玎	dye
钥	yxue
耙	bqee
蛹	ylia
腺	xcua
犒	kvue
浚	jzoo
湍	troo
赧	nfei
阗	tf;i
姒	sma
銮	lf;e
羚	lhou
忪	zooo
镭	ldue
獗	jdua
峪	ynia
摈	bzei
暹	xr/
豌	wre
恹	yroo
忾	kqo
囵	ls/
闳	hl;i
蠹	dnv
濑	lqoo
抨	pye
呲	ziia
叵	plv
踮	dfi
粑	bqo
挈	qxv
谗	cfoa
勖	xni
柠	nhei
胛	jau
纫	rza
绌	cna
咯	geia
咯	l/i
翕	xm;
坂	bfe
欹	yieu
囤	dz/
颏	keo
唢	sli
鸪	gue
酵	jvei
渚	zjoo
韭	jl/e
桠	yqei
魃	ba;
铝	ljue
磺	h;eu
篑	kx;e
靛	dcee
觊	jmi
潢	h;oo
牒	ddui
郸	drou
傥	t;ui
岫	x/ia
亟	jk/i
榛	zwei
鳝	scua
爿	pf/
爿	q;/
覃	tfv
钺	yxue
嗲	dai
铳	c/u
鸶	si/a
馔	zcu
觎	yjuo
磬	qbvi
桎	zmei
樽	zwei
蹰	cjia
仞	rzu
馊	soua
琬	wfee
噙	qsi
诰	gvo
檄	xke
奁	lfvu
疹	zs;
棂	lhei
柑	grei
蠊	lfi
巽	xz/e
汛	xzoo
遨	rgve
汾	fso
麝	sx;e
殛	jkeu
喑	ywi
蛔	hdi
遛	l/;a
菡	hcv
贽	zmvi
唁	yci
戕	qpa
饪	rzua
畿	ji/a
爰	yf;o
煊	xro
弋	ymva
讦	jdoa
钜	jnue
铄	s/ue
蜢	mhia
燧	sxou
苜	mnvi
呤	lhia
僖	xiui
舂	cove
鸩	zzo
弭	mkae
琮	clee
灸	jl;a
釉	y/uo
碱	jfeu
愠	yzoo
迨	dq/o
锟	kwue
揆	kdei
狎	xaua
蹴	cni
淄	zioo
缢	ymaa
曷	hd/
洱	rdoo
玥	yxe
阒	qn;
楔	xeei
掼	gcei
硅	geeu
蘅	hhv
鹌	rreu
仃	dyui
艄	stuu
镳	btue
昀	ysia
峒	d/ia
蓑	sovi
堇	jsv
奂	hc;a
炷	znou
褡	dqo
撷	xdei
涝	lvoo
悌	tmoo
鹧	zxoe
忻	xwoo
苯	bsv
邝	kpoe
沣	fyoo
夯	hpvu
颚	rxia
耆	qkvi
蓟	jmvi
阪	bfa
瑄	xree
谩	mfo
翊	ymoe
榔	l;ei
糗	qlou
贲	bwv
贲	bmvi
跻	jiia
捍	hcei
翦	jf;u
埂	ghei
觐	jzei
竣	jzoe
橇	qte
秆	gfue
铢	zuue
媪	rgau
睚	yai
胫	jbua
磔	zdeu
肪	f;ua
澹	dcoo
泗	smoo
帏	wdia
黜	cnia
獒	rgve
晟	ch/a
谲	jdoa
禺	rl/a
禺	yj/a
榈	ljei
踅	cmvi
踅	xdvi
楹	yhe
咤	zqia
忝	tfve
嫔	psa
趔	lxvi
骛	wn/
踽	jjia
笏	hn;e
帼	gli
睑	jfi
焙	bxou
琊	yae
铀	ylue
漳	zpoo
赣	gcoe
倨	jnui
螭	ciia
脍	kqua
粕	p/o
肱	goua
倜	tmu
萼	rxvi
箔	bl;e
黍	sj;e
汜	smoo
祚	z/oa
诓	kpoa
砺	lmeu
滟	ycoo
斛	hjua
杷	pae
撺	crei
觥	goua
螫	zev
恚	hxvi
疟	nx;
疟	yv;
磴	dbe
柘	zxei
睥	bmia
誊	th;u
孬	nt
蜮	ynia
霈	pxv
膘	btua
沱	tloo
啖	dci
罂	yy/a
鲛	jtua
徇	xzuu
骧	xpa
姝	suau
偻	llui
偻	ljui
苋	xcv
鳗	mfua
唳	lmi
摞	l/ei
荚	javi
僭	jcui
鏖	rg;
谡	snoa
箬	r/;
袤	mv;e
枇	pke
湫	jgo
邈	mg;
烩	hxou
荩	jzvi
泾	jyoo
鸵	tlua
宥	y/;
羯	jdou
濛	mhoo
哐	kpia
圜	hf/a
诤	zboa
莞	gfvi
莞	wfv
桉	rrei
潋	lcoo
汐	xioo
狷	jcua
熨	yn/e
襁	q;o
跎	tlia
睢	seia
锷	rxue
髭	zivi
泵	bbv
聩	kxe
臌	gjua
湄	mdoo
逖	tm;
儆	jhu
葩	pqv
裨	bmoa
荞	qgv
轲	keea
盥	gc;
纰	pia
癯	qj;
妤	yjau
钛	tque
侧	zqui
锃	zbu
葺	qmvi
牖	ylui
绡	xtaa
蹉	coi
钠	nqu
囫	hj/a
尾	yk/e
岂	ka/
秸	jeue
虻	mhia
酗	xne
擤	xhei
逡	qw/
昶	c;;a
郦	lmei
俦	clui
驽	nj/u
逅	h/;u
锌	xwue
刎	wsua
茏	llvi
囿	y//
愎	bmoo
鱿	ylua
痔	zm;e
魈	xt;i
栉	jdei
猊	nkua
椿	cwei
茴	hdvi
碣	jdeu
闼	tq;
矍	jd/a
蜚	fd/e
彀	g/ei
莆	pjvi
砒	pieu
摁	rzei
趄	juv
趄	qxvi
什	ssu
褓	bgoa
嶂	zpia
湎	mfoo
犸	mau
畹	wfia
萋	qivi
噱	jdia
咩	mei
幄	w/ia
蒯	kaei
尺	cd/
籽	zkou
蓁	zwv
魉	l;;i
飨	x;a
樨	xiei
绶	s/a
獐	zpua
濯	zvoo
濯	zloo
痍	yk;e
姹	cqa
辔	px/
厩	j/v
剜	wroo
镫	dbue
殁	m/e
旃	zroe
呔	tqia
绰	ctaa
膻	srua
齑	ji;e
荻	dkv
杓	btei
杓	sgei
荦	l/v
鹘	gji
怼	dx/
笳	jq;
醮	jvei
卟	bjia
鹗	rxia
漕	cgoo
胱	gpua
崂	lgia
赝	ycvu
驷	smaa
懔	lsoo
麋	mk;e
汨	mmoo
嗵	toi
躅	zjia
薮	slvi
骅	haaa
伥	cpui
伉	kpu
葭	jqvi
腓	fdu
雠	clui
孱	cc/e
鹜	wn/o
蛎	lmia
凫	fj;a
浔	xsoo
稔	rsue
鄱	plu
讵	jnoa
莠	ylvi
陲	cda
圻	qkei
啭	zcia
馗	kd;a
岷	msi
壅	yo;e
僮	tlui
僮	zpui
藜	lkvi
嘣	byi
徕	lau
氯	ln;e
徉	y;uu
璎	yyee
秣	m/ue
拮	jdei
镁	mdu
莅	lmvi
遒	ql;u
荏	rsv
俳	paui
庾	yj;e
蚨	fjia
竽	yj;e
囹	lh/
蓿	xuvi
踯	zkia
狒	fxua
蔫	nrv
骞	qr;o
邂	xx;a
墒	spei
悭	qroo
逦	lkvi
锺	zoue
锲	qxu
眇	mgia
傣	dau
荥	xhvi
挹	ymei
缦	mca
酆	fyee
纡	yua
酩	mhei
鄢	yre
嵬	wd/a
藓	xfvi
阡	qra
缟	gga
痼	gn;e
潸	sroo
讧	h/oa
鳍	qkua
箴	zw;e
饴	ykua
茔	yhvi
罹	lk/
泫	xcoo
椁	glei
唿	huia
崴	wa/
蜍	cjia
篁	h;;e
暝	mhia
酊	dhei
砧	zweu
濮	pjoo
徜	c;uu
铣	xkue
匮	gxv
彧	ynva
邙	m;oe
颢	hvi
栾	lf;e
岬	jai
傕	jdui
闱	wd;i
栀	ziei
铰	jgue
舢	sruu
寮	lg;o
蠡	lk/a
跆	tai
荑	tkv
挝	woe
裾	juo
擘	b/
酡	tlei
媾	g/a
珩	hhe
恽	yzoo
惇	dwoo
澧	lkoo
埔	bnei
钤	qfue
祉	zkoa
仟	qrui
帔	pxi
镞	zjue
钿	dcue
阍	hw;i
珣	xse
氨	rr;e
黧	lk;e
矾	ffe
棹	zoei
铉	xcue
阚	kc;
骓	zea
枰	phei
牝	pzu
蝈	goia
瞽	gjvi
迤	yk;e
胺	rcu
淦	gcoo
佶	jku
祛	quo
樾	yxei
痂	jq;e
颛	zria
尿	se/
觯	zmua
寤	wn;o
殚	dreu
轸	zsea
佰	bau
诂	gjoa
蒺	jkvi
猗	yiua
谌	csoa
鸱	ciu
町	thia
眬	llia
禛	zwoa
鳏	grua
拊	fjei
沆	hpo
噌	cyia
奘	zp/
奘	z;/
玟	msee
玟	wse
貉	hduo
貉	m/uo
岈	yaia
滦	lfoo
嫒	rqau
涪	fjoo
绦	dkaa
绦	tta
遴	ls;u
舛	cfua
玕	gree
蔚	ynvi
狻	srua
砭	breu
愆	qr;u
啁	zoia
祭	zq;a
烊	y;ou
撸	lue
杈	cqei
蚝	hgia
锉	c/ue
臬	nx;i
韪	wd/a
谔	rxoa
谯	qgoa
雒	l/ua
箐	qb;
肓	hp;
韫	yzee
恁	nz;
垩	rxvi
镬	h/ue
嫫	mlau
偈	jmui
啵	boi
羸	ld;
苻	fjvi
醴	lkei
霰	xcvo
疽	ju;
叁	sr/o
鬣	lxvi
嗄	raia
猕	mku
跖	zkia
佝	goui
薨	hov
菟	tnv
葳	wevi
侗	d/ui
酶	mdei
焘	dvv
绻	qfa
潍	wdoo
氮	dc;e
鬻	yn/e
癣	xf;e
牦	mgue
铤	dbue
仨	squi
豸	zm;o
睾	gt;i
赍	jivi
舄	xm;i
俅	qlui
膑	bzu
莜	ylvi
逶	we;e
蚋	rxia
拽	yxei
龈	ysie
聃	drei
玠	jxe
猡	llua
汞	glvi
陟	zma
邳	pieu
蠃	ll;e
戗	qpuo
龅	bti
箓	ln;e
擢	zlei
繇	ygu
繇	yluo
呖	lmia
搦	n/ei
钾	jaue
螟	mhia
辚	lsea
瀑	bvoo
辂	lnea
骢	coaa
亳	bl;e
肛	gpua
砝	fae
蛭	zmia
綦	qkvi
歙	sxuo
搴	qr;o
虹	jpi
蔺	lzv
搠	s/ei
铱	yiue
镐	ggue
赅	gqi
鞅	ypei
牟	mn/
艮	gs/
祜	hnoa
煅	dcou
仝	tl;o
圄	yj/a
瘌	lq;e
坨	tlei
圩	wdei
犟	jp/
柙	xaei
怫	fxoo
怫	fjoo
崧	so/a
楂	caei
衿	jwoa
殄	tfeu
昴	mg/a
槿	jsei
掴	glei
莒	jjvi
缱	qfaa
鎏	ll;o
醐	hjei
钙	gque
哓	xtia
厝	c/v
醍	tkei
虢	gluo
錾	zcva
衽	rzoa
阆	l;;i
菏	hdvi
灞	bqoo
碘	dfeu
薏	ymvi
苒	rfvi
缁	ziaa
炘	xwou
獬	xxua
狯	kqua
痿	wd;e
苫	srv
廪	ls;e
圉	yj/a
菅	jrv
郧	ysia
嶷	yk/a
毂	guei
蕲	qkvi
脶	llua
蘧	qjvi
碇	dbeu
晷	gd/a
嵯	clia
芸	ymvi
笄	ji;e
杼	znei
兕	sm/a
嚯	h/i
舸	gdu
槊	s/;u
碜	cseu
嫚	mcau
瘀	yu;
哞	moi
锗	zdu
耒	ldve
砣	tleu
骝	llaa
猱	ngu
糅	rlou
貅	xouo
溧	lmoo
犴	rcua
訇	ho;
郏	jaeo
乜	me/
铙	ngue
螯	rgve
夤	ys;a
掾	ycei
仵	wjui
琚	juee
嚭	pkei
蝮	fnia
屌	dg/e
珉	msee
殷	yruu
膂	lj;e
铬	gxue
峤	jvi
炅	gx/a
蕨	jdvi
貔	pkuo
糨	jpo
赉	lqv
镛	youe
砀	dpeu
腩	nfua
铩	sque
嫱	q;a
抟	tfei
颙	ylia
薜	bmvi
烷	wfou
狴	bmu
缃	xpaa
蝾	rlia
抻	cwei
嘞	lei
爻	yg;o
嬛	hfau
黢	quia
狍	pgu
滁	cjoo
烃	tyou
璺	wz;
呙	go/a
耋	ddv
镏	llue
痫	xf;e
祆	xroa
轾	zmea
欸	rea
芩	qsvi
娩	mfau
娩	wfau
鼬	y/ui
珐	fqe
墉	yoei
筮	sm;e
衩	cao
窣	sn;o
瑗	ycee
窸	xi;o
貊	m/uo
椋	l;ei
畲	se;
铧	haue
鸮	xtia
妊	rzau
疥	jx;e
珲	heee
楸	qoe
纥	gea
窳	yj;o
煲	bt;i
钨	wuue
郓	yzoa
灏	hvoo
蓍	sivi
茯	fjvi
硭	m;e
酢	cnei
旮	gq;a
絷	zkvi
珪	geee
婺	wn/o
璟	jhe
邴	bhe
歃	sque
鳕	xdua
驺	zoaa
疡	y;;e
靺	m/ei
烯	xiou
洙	zuoo
鲧	gsu
偾	fzu
黩	djia
孢	btai
鞨	hdei
媸	cia
缛	rna
泖	mgoo
蟊	mg/o
锜	qkue
轱	guea
旯	la/
褫	ckoa
妁	s/au
纛	dvve
孛	bxvi
迓	yqva
谶	czoa
檑	ldei
墀	ckei
闫	yf;i
祧	ttoa
氐	di;
蚺	rfi
姮	hha
獾	hrua
郗	ciuo
鼹	yfui
椤	llei
矞	yn/o
钴	gjue
柞	z/ei
锴	kaue
岿	ke/
菀	wfvi
晗	hfia
茕	qlvi
荇	xbvi
笮	zd;
喆	zdei
胪	ljua
馏	llua
箩	sk;e
傈	lmui
鞬	jrei
巯	qla
鲽	ddua
曌	zv/a
猁	lmua
钲	zyue
埙	xwei
涫	gcoo
铆	mgue
嗞	ziia
哙	kqia
蜇	zevi
逑	qlvi
炻	skou
跹	xria
铂	blue
徭	yguu
猞	seu
铖	chue
邛	qlei
蓐	rnv
佺	qfui
貘	m/uo
凼	dp/
鋆	ysvi
镗	tpu
稹	zsu
涞	lao
炔	gxo
杲	gg/
钎	qrue
陂	pka
陂	poa
蜉	fjia
悱	fdoo
棻	fwvi
珙	glee
栎	lmei
缳	hfaa
脔	lf;e
锝	ddue
蕤	rdvi
螈	yfia
荜	bmvi
洌	lxoo
炆	wso
獍	jbua
瘙	sv;
镍	nxu
粥	ynae
纩	kpa
莳	smvi
旻	ms/a
冼	xfoe
鹬	ynao
锒	l;ue
氦	hq;e
湟	h;oo
赑	bm/a
篾	mx;e
郅	zmea
堞	ddei
暾	twi
鼐	nq/
鲟	xsua
偬	zlui
炝	qpo
裎	choa
硌	gxeu
咴	heia
竦	sloe
邰	taa
蓼	lgvi
蓼	lnvi
琇	x/e
苌	c;vi
昺	bh/
侔	mlui
娠	swau
腱	jcua
鳃	squa
洮	tgoo
眙	ykia
尜	ga/
蝰	kdia
鼋	yfve
腚	dbua
瞵	lsia
椴	dcei
洹	hfoo
趺	fui
庹	tl;e
盱	xuia
犍	jrue
噻	sqia
镊	nxue
珥	rde
狃	nlua
撄	yyei
伈	xsui
峄	ymia
杌	wnei
鏊	rvve
吡	bkia
馐	xoua
鼍	tl/a
荛	rgvi
昃	zx/a
蹼	pji
娈	lf;e
镝	diu
擀	gfei
殳	su;
唵	rfia
蟥	h;ia
狁	ysua
雱	p;v
犰	qlua
訾	zi/
泷	lloo
泷	spoo
裢	lfoa
踟	ckia
沭	snoo
鞡	lqei
嘬	cqia
厣	yfvu
锰	mhue
焖	mzo
瘐	yj;e
璁	coee
骐	qkaa
虺	hevu
黟	yiia
腭	rxua
瘿	yh;e
芨	jkvi
稞	keu
苡	ykvi
酃	lheo
妣	bka
瑷	rqee
戡	krei
蛉	lhia
勐	mha
澍	snoo
沨	fyoo
骘	zm/i
雩	yjvo
筅	xf;e
郿	mdai
诜	swoa
憷	cnoo
郇	xsua
襦	rjoa
吖	rqia
檫	caei
垭	yqei
飏	y;;a
邗	hfee
垓	gqei
佤	wau
苕	tgvi
芫	yfvi
矽	xieu
謇	jf;o
氟	fj;e
蝓	yjia
煸	bro
酮	tlei
锨	xrue
喈	jeia
沔	mfoo
鲑	geua
蜊	lki
蕈	xzv
刭	jhao
鲵	nkua
鄯	scou
愀	qgoo
堠	h/e
纮	hlaa
鳟	zwua
瓤	r;o
氰	qh;
枸	glei
瀣	xxoo
鲰	zoua
坩	grei
陉	xha
褰	qr;o
渑	mfoo
裣	lfoa
笫	zk;e
荠	jmvi
缗	msa
阄	jo;
疱	pv;
玦	jdee
尻	kt
罴	pk/
艏	sluu
燹	xfvu
肏	cv
旒	lloe
孳	zi;u
眭	seia
樯	q;ei
氖	na;
鲶	nfua
倥	kou
蒹	jrvi
枋	fpei
菘	sovi
怛	dao
淝	fdoo
榉	jjei
鲈	ljua
忉	dtoo
萑	hfvi
栳	lgei
逋	bu
觜	zi/e
觜	zd/
蚍	pkia
〇	lh//
殍	pgeu
蝣	ylia
麂	jk;e
埚	goei
焯	ctou
矬	clue
谰	lfoa
趸	dsv
縻	mk;e
艨	mhuu
瓴	lhuo
叻	lxia
蹚	tpi
勰	xda
桔	jjei
翥	znvi
侪	caui
喱	lkia
桫	soei
漯	tqoo
茑	ngv
鲠	ghu
跗	fuia
焓	hfou
笤	tg;e
磻	pfe
洄	hdoo
篦	bm;e
鹕	hjei
雎	jui
窨	xw;o
窨	yz;
邽	geei
昉	f;i
阋	xm;i
夯	bzvu
钬	hlue
咋	zdia
鹈	tko
艟	cou
疴	ke;e
颎	jlu
棼	fsvi
砬	laeu
锍	llue
跸	bmia
濉	seo
漭	m;oo
逄	p;;a
埘	skei
蝥	mg/o
蚧	jxi
塄	lhei
萘	nqvi
剡	scou
趿	tqia
彖	tc/a
郯	tfou
鼙	pkvi
嘌	pti
螫	smvi
鲇	nfua
蚜	yaia
帑	t;/u
孬	hqvu
赟	yw;e
溘	kxoo
璆	qlee
稗	bque
洇	yroo
洇	ywoo
岢	kd/
矸	greu
睃	soia
扦	qre
闿	ka;
轳	ljea
蟛	phi
菔	fjvi
觋	xkei
枥	lmei
哚	dlia
烺	l;ou
旄	mgoe
蛄	guia
蚰	ylia
锱	ziue
醪	lgei
倬	zoui
囟	xz;
狳	yjua
耔	zkee
嗉	sni
鞒	qgei
鋈	wn;o
曈	tlia
毖	bmva
潆	yhoo
鳐	ygua
嬗	scau
侑	y/ui
槎	caei
锑	tiu
豳	bw/
锕	rqu
渌	lnoo
禳	r;oa
吽	hoia
昽	llia
辊	gse
捭	baei
疣	yl;e
孥	nj/u
芪	qkvi
耪	p;e
榫	ssei
蛩	qlvi
薅	htv
莰	kfv
萁	qkvi
罨	yf/a
龃	jjie
蜞	qkia
酽	ycei
氪	kx;e
栲	kgei
崤	ygia
钯	baue
镕	rlue
捌	bqei
铋	bmue
觚	guu
毽	jc;e
螽	zo;a
嫜	zpau
缒	zxaa
刖	yxua
瘢	br;
茌	ckvi
砷	swe
骶	dkia
糁	sfo
溏	t;oo
鹚	ckou
穑	sxue
鲀	tsua
樘	chei
樘	t;ei
坭	nkei
滹	huoo
瞋	cwia
戽	hn;a
攮	n;e
愍	ms/e
髋	kri
飧	swua
冱	hnoe
匏	pgeu
艉	wduu
鲂	f;ua
橛	jdei
殂	cjeu
痈	yo;e
蠼	qji
鞯	jrei
枞	coei
嵊	sbi
澶	cfoo
樗	cue
辌	l;ea
岙	rv;e
遄	cf/
垸	ycei
椟	djei
尕	ga/u
鹾	clie
蔌	snvi
龉	yjie
髡	kwv
橼	yfei
髁	keia
芰	jmvi
瓠	hneu
皲	jwoa
椐	juei
锞	kxue
鸹	gque
隈	wea
龋	qjie
圹	kpei
莪	rdvi
彘	zm/a
龁	hdie
餍	ycvu
榖	gjei
垱	dpei
暌	kdia
泔	gro
赜	zdei
筚	bm;e
嘡	tpia
蓖	bmvi
甑	zbou
饧	t;ua
檠	qhvi
朐	qjua
蹁	pfia
蚬	xfi
疠	lm;e
鸬	ljie
桁	h;ei
桁	hhei
螅	xiia
铗	jaue
芎	xov
绂	fja
宄	gd;o
晞	xiia
亶	df;
髫	tgvi
摭	zkei
奭	smvu
枳	zkei
蔟	cnvi
嗐	hqia
鍪	ml/o
苷	grvi
妫	geau
圯	ykei
骟	scaa
柁	tlei
熘	loo
茭	jtvi
钡	bxue
棰	cdei
盍	hdvi
铊	tque
秫	sjue
苴	juvi
鞣	rlei
耨	n/ee
硼	pheu
礅	dweu
袪	quoa
栌	ljei
飑	bt;a
钪	kpue
栊	llei
郴	cwei
肄	ymua
醚	mke
敉	mkou
袆	heoa
涑	snoo
缡	lkaa
脘	gfua
膈	gdua
酎	z/ei
瘆	sz;e
跏	jqi
箜	ko;
鲳	cpua
秭	zkue
柒	qi;
蛳	siia
茈	zkvi
痱	fx;e
谵	zroa
龢	hduo
圊	qy/
笥	sm;e
蟮	scia
氚	cr;e
捩	lxei
镆	m/ue
穰	r;u
枵	xtei
镪	q;u
堀	kuei
阏	rx;
皴	cwa
焐	wnou
祎	yioa
馕	n;u
鳓	lxua
瓿	bnoe
菖	cpvi
湜	skoo
蒌	llvi
眚	sh;
浠	xioo
邡	fpoe
圮	pkei
儋	dru
粳	jyou
绐	dqa
闶	kp;i
苎	znvi
廨	xx;e
怙	hnoo
幪	mhia
芴	wnvi
酰	xrei
黥	qhia
楗	jcei
钭	tlue
莨	lpv
觳	hjei
豨	xieu
柽	cyei
琯	gfee
蓊	wh
酾	sqei
喾	kn;
笊	zv;e
芏	dnvi
玡	yaee
曛	xwia
愦	kxoo
馑	jsua
俣	yjui
魆	xn;i
曩	n;/
剀	kaia
袢	pcoa
僳	snu
卮	zi;u
硒	xieu
榧	fde
鹣	jrou
桡	rgei
倧	zoui
汊	cqoo
秾	nlue
鲷	dtua
旆	pxoe
蘖	nxvi
癍	br;e
蕖	qjvi
仂	lxui
莴	wov
珅	swee
嫠	lkve
蕞	zxvi
钣	bfue
蘼	mkv
卺	js/
垆	ljei
焗	jjou
镒	ymue
屣	xk/e
藿	h/vi
怃	wjoo
鸰	lhuo
锆	gvue
玢	fwe
柰	nqvi
铴	tpue
缶	fl;
鳔	bvua
蓥	yhvi
詈	lm/a
蛑	mlia
鼗	tg;o
芾	fxv
芾	fjvi
鲆	phua
癔	ym;e
妗	jzau
钚	bnu
酲	chei
麈	zj;e
碓	dxe
蛞	k/ia
鄣	zpoe
骖	cra
揸	zqei
谝	pfo
鹩	lgeu
檩	lsei
赀	zi/e
抔	ple
蜣	qpia
趵	bvi
黻	fjii
蜩	tgia
屙	re/
缂	kxa
燔	ffou
溽	rnoo
塬	yfei
笸	pl;
痦	wn;e
碛	qmeu
玘	qkee
碚	bxe
阊	cp;i
蕺	jkvi
岘	xcia
旸	y;i
鄄	jcei
胙	z/ua
烜	xfou
璘	lsee
伛	yjui
孓	jd/i
锊	lxue
珰	dpee
焜	kwo
溱	zwoo
揠	yqei
璠	ffee
萏	dcvi
昝	zf;a
铍	pkue
镧	lfue
邶	bxi
硎	xheu
芑	qkvi
啫	zdia
缬	xdaa
坼	cxei
糌	zrou
隹	ze;i
崃	lai
戢	jki
幞	fjia
坫	dcei
絜	jdve
忭	bcoo
獴	mhua
哕	ydia
笾	br;e
敫	jgui
髀	bmia
碹	xceu
槠	zuei
酯	zkei
菽	suvi
鲢	lfua
嗍	soia
艿	nav
仳	pkui
圬	wue
甏	bpv
胝	ziua
锛	bwue
豉	ckei
磙	gseu
厍	sxvu
筌	qf;e
苣	jnvi
辏	c/ea
廑	js;
瞢	mhvi
鳎	taua
箪	dr;e
钒	ffu
诹	zooa
僰	blvi
癜	dc;e
诼	zloa
荨	qfvi
篪	ck;e
颞	nxe
檗	b//
缯	zba
坻	dkei
轫	rzea
郾	yfea
猇	xtua
锂	lkue
鞫	jjei
耩	j;e
蛱	jaia
槲	hjei
氘	dt;
缌	sia
麸	fuee
唣	zvia
卣	yl/e
椹	sze
铟	ywue
嘏	gjei
嘏	jaei
啉	lsia
琤	cyee
璩	qje
泺	l/oo
蓠	lkvi
黾	mf/a
裉	kzo
哏	gsi
苁	covi
唑	z/i
薹	tav
锘	n/u
阌	ws;i
茺	covi
瘰	ll;e
堙	ywe
缫	staa
嗾	slia
圪	geei
砗	ceeu
狨	rlua
尥	lvv
狺	ysua
胗	zwua
羝	diou
茼	tlvi
铯	sxue
杩	mqe
顸	hree
麇	jw;e
刳	kueu
蘩	ffvi
酹	lxei
绲	gsa
颟	mr
蠓	mhia
郐	kquo
缧	lda
溲	sooo
赓	gy;e
翮	hdei
镢	jdue
髎	lgia
唛	mqia
溻	tqoo
痤	cl;e
隳	he/
嵛	yj/a
怍	z/oo
饫	ynua
腧	snua
踬	zmia
鹋	mgei
蠲	jrou
陔	gqa
芡	qcvi
畚	bs/
呒	fjia
颃	h;oe
旰	gci
帻	zdia
瘳	co;e
荭	hlv
垲	kaei
跣	xfia
疸	df;e
刈	ymuo
朊	rfua
龠	yx;o
湉	tfoo
嵴	jkia
鞲	goei
鹀	wjei
硖	xaeu
鲞	x;;u
萸	yjvi
馓	sfu
醢	haei
牂	zpai
蚴	y/i
嬖	bm/e
胼	pfu
糍	ckou
踺	jcia
庑	wj;e
嗌	rqia
铒	rdue
瘘	l/;e
鄞	ysei
绨	tkaa
峁	mg/a
颡	s;a
屦	jn/e
栝	gqei
痧	sq;e
堋	phei
辒	wwe
镲	caue
鸲	qjua
粝	lmou
芘	pkvi
徼	jguu
嘚	deia
戥	dhi
仉	z;u
葸	xkvi
耧	llee
侉	kaui
篌	hl;e
疔	dy;
踔	coia
葑	fyvi
捽	zjei
凇	sooe
掭	tcei
梃	thei
虿	cqva
谇	sxoa
鸤	siae
鲮	lhua
谳	ycoa
褟	tqoa
泮	pcoo
廛	cf;e
缣	jraa
胍	gqua
莼	csvi
皤	plui
畈	fcia
嗪	qsia
裰	doo
陧	nxa
铘	ydu
毳	cx;e
醑	xjei
簟	dc;e
蹀	ddia
燠	ynou
谖	xroa
鲋	fnua
镋	t;ue
枧	jfei
舻	ljuu
沤	r/oo
阇	sd;i
阇	du;
蝤	qlia
庋	gd;e
梿	lfei
酐	grei
邾	zuue
龀	czi
诖	gqoa
醅	pee
轭	rxea
鹮	hfia
藁	ggv
贶	kpia
匦	gdva
菹	zuvi
琫	bhee
笕	jf;e
蒴	s/vi
峣	ygia
僬	jtui
醛	qfei
趑	zivi
锬	tfue
吣	qzi
浜	bwoo
浜	bpoo
垧	s;ei
肭	nqua
鬲	lmvi
鬲	gdvi
陴	pkai
锩	jfue
胲	haua
菰	guvi
桴	fjei
榇	cze
冏	jl/a
鸸	rdeu
鬏	jovi
洧	wdoo
劬	qjua
柝	t/ei
疝	sc;e
拶	zfei
箅	bm;e
肽	tqua
舯	zouu
嵝	llia
煳	hjou
鲔	wdua
葙	xpvi
芤	kov
悛	qroo
鳊	brua
埸	ymei
艋	mhuu
钼	mnue
躜	zria
礞	mheu
劂	jdeu
剞	jieu
黹	zk/i
愔	ywoo
硪	w/eu
佾	ymui
磲	qjeu
鬯	cp;o
洚	jpoo
隰	xkai
谠	d;o
鲥	skua
牁	geai
甍	mhvi
铪	hque
呋	fuia
趱	zfvi
绀	gca
髌	bzi
楝	lcei
埕	chei
砜	fyeu
麹	que
鹨	l/ao
垤	ddei
埵	dlei
獯	xwua
唪	fhi
伲	nkui
媵	ybu
觫	snua
潲	svo
髂	qqi
墁	mce
鲱	feu
碲	dmeu
辋	w;ea
绱	spaa
嫘	ldau
胬	nj/u
蛏	cyia
岣	glia
枘	rxei
刿	gxia
瘵	zq;e
羼	cc/e
罟	gj/a
崦	yria
躞	xxi
鲎	h/;o
窭	jn;o
亓	qkve
湔	jroo
蚶	hri
鹆	ynuo
慝	txva
俜	pyu
羑	yl;u
锶	siue
啶	dbia
怿	ymoo
诎	quoa
骱	xxia
蔸	dovi
鐾	bx/e
绁	xxa
铵	rfue
逯	ln/e
酚	fwei
砘	dze
汆	cr;o
菝	bavi
饩	xmu
笪	da;e
蒽	rwv
芟	srvi
崮	gn/a
浯	wjoo
屺	qkia
岵	hni
柃	lhei
绋	fjaa
檎	qsei
锾	hfu
毹	suuo
郄	xmuo
溷	hzoo
芄	wfvi
掎	jkei
齁	hou
銎	qov
镡	tfue
搛	jrei
劓	ymui
谮	zzoa
肟	w/u
锳	yyu
毵	srao
粜	tv/
俶	cnui
蓣	ynvi
觖	jdua
嘧	mmi
悝	lkoo
悝	keoo
氆	pj;e
撙	zsei
劢	mqea
氇	lj;e
跬	kdia
庥	xo;e
嵫	ziia
擐	hcei
鳜	gxua
篼	do;e
蝻	nfia
慊	qxoo
蠖	h/ia
舾	xiuu
莸	ylvi
湓	pso
鹍	kwi
腽	wqu
汔	qmoo
褊	bfo
蛴	qkia
塍	chua
骀	dqaa
眄	mcia
葚	szvi
槭	qmei
孖	ziai
蛸	sti
蛸	xtia
瘗	ym;e
酴	tje
肷	qfua
钽	tfue
鱽	dtua
篥	lm;e
箦	zd;e
袷	jao
崾	ygia
跫	qlvi
袼	geoa
镚	bbu
倮	llui
阃	ks;
黪	cfia
郤	xmuo
渫	xxoo
鞔	mfei
溆	xnoo
埽	sve
荽	sevi
锸	cque
笱	gl;e
扃	jo;a
鹪	jtui
硗	qteu
浼	mdoo
芈	mk/
肼	jhua
舳	zjuu
縠	hjei
缑	goa
遘	g/ve
簋	gd;e
瓞	dd;u
滏	fjoo
僦	j/u
黼	fjii
杪	mgei
鲭	qyua
蛲	ngia
蒉	kxvi
仡	ymui
仡	geui
桄	gpei
澌	sioo
氡	do;e
芗	xpvi
氩	yq;e
锼	soue
籼	xrou
佴	rxui
龆	tgie
煺	txo
胂	szua
砟	zaeu
溴	x/oo
逭	hc;o
弢	ttae
砻	llvu
肫	zwua
秕	bkue
苤	pdv
髑	djia
楯	ssei
躐	lxia
疃	tfi
钌	lgue
斝	ja/a
吲	ysia
糇	hlou
綮	qk;a
踣	blia
鼯	wjui
浍	hxoo
黉	hl;o
臜	zqua
钋	pou
裥	jfoa
禊	xmo
犋	jnue
垌	d/ei
炱	ta/
儇	xrui
耜	smee
缵	zfa
葶	thvi
蟪	hxia
桷	jdei
跐	ckia
搌	zfei
菪	dpv
蛘	y;ia
硐	d/eu
鹁	blei
镉	gdue
蝽	cwia
迕	wj;e
镘	mcu
铞	dvue
筇	ql;e
腠	c/ua
陬	zoai
嶓	boia
锇	rdue
徂	cjuu
畛	zsi
霪	ysvo
觇	crie
砹	rqeu
钫	fpu
罽	jm/a
锪	houe
氙	xr;e
螨	mfia
媭	xu;
坜	lmei
叆	rqee
畀	bm/a
穸	xi;o
镱	ymue
埤	pkei
虼	gxia
膦	lzu
岜	bq/a
眢	yr;a
蹽	lti
楦	xcei
湲	yfoo
巉	cfia
畋	tfia
烀	huou
簏	ln;e
碡	djeu
埴	zkei
铈	smue
莩	fjvi
莩	pgv
淠	pmo
薷	rjvi
爨	cc;i
轺	ygea
鸫	doea
榍	xxei
埝	nce
胨	d/ua
鲦	tgu
冁	cfou
铥	dou
胩	kaua
窀	zw;o
邠	bwuo
晡	bui
潴	zuoo
漤	lfoo
籴	dk;o
镦	dxu
萆	bmvi
榱	ceei
鹖	hdia
锿	rque
罱	lf/a
髹	xovi
鳇	h;ua
崚	lhia
骒	kxaa
羰	tpo
掊	plei
悃	kso
蒇	cfvi
浞	zloo
铚	zmue
舴	zduu
鹱	hnu
疬	lm;e
噍	jvia
虮	jkia
苊	rxvi
稂	l;ue
裒	pl;e
墼	jivi
镓	jque
鲡	lkua
垕	h/;u
攉	hoe
羟	q;ou
槔	gte
诔	ldo
靸	sae
苈	lmvi
砑	yqeu
浥	ymoo
帙	zmia
茛	gzvi
莛	thvi
罘	fj/a
谂	ssoa
襞	bm/e
钕	nju
疳	gr;e
钔	msue
蠋	zjia
枸	jjei
嚄	h/ia
嚄	rlia
龈	ksie
澉	gfo
惙	c/oo
舁	yj;i
牤	mp
殪	ymeu
郫	pkui
氍	qjia
蜱	pkia
鹇	xfoi
牾	wjue
聍	nhei
饹	leu
酞	tqei
埒	lxei
哌	pqia
臑	nvu
荸	bkv
籀	z/;e
珧	ygee
悫	qxvi
骺	hlia
镎	nau
筘	k/;e
饔	yo;e
鳙	youa
骣	cfaa
跽	jmia
疖	je;
桕	j/ei
洫	xnoo
潾	lsoo
硇	ngeu
瓘	gcee
腈	jyua
嵎	yjia
镮	hfue
粢	zi;e
镅	mdue
唼	saia
戆	gp;e
戆	zp;e
滃	who
钐	srue
钍	tjue
颥	rje
赙	fnia
畎	qfia
矧	ssue
漶	hcoo
鹔	sna
坌	bz;
哿	gd/u
沩	wdoo
艚	cgu
桊	jc;u
瀹	yxoo
鲼	fzua
鄹	zoei
岽	do/
觌	dkei
眊	mvia
鲖	tlua
苄	bcv
鸻	hhuu
锖	qpue
瘊	hl;e
褙	bxoa
豇	jpe
帱	clia
帱	dvi
欻	huou
裼	xioa
艽	jtvi
锽	h;ue
镨	pjue
瘛	cm;e
醵	jnei
搋	cqei
瘕	ja;
侂	toui
瘼	m/;e
哳	zqia
鸺	xoui
瞍	slia
鲒	jdua
锔	jjue
沚	zkoo
羧	soou
鳘	ms;e
驵	z;a
葜	qqv
恧	nnv
氕	pe;
洳	rnoo
钆	gau
柈	pfei
恝	jave
粞	xiou
惝	t;oo
镄	fxue
鲅	bqua
砉	xuve
铕	ylue
轵	zkea
聱	rgve
襻	pcoa
埯	rfei
骎	qwa
铌	nkue
茆	mgvi
迮	zd;e
脬	ptu
蓰	xkvi
嶒	chi
祓	fjoa
鞴	bxei
伭	xfui
瘅	dc;e
戋	jrve
铷	rjue
忮	zmoo
椠	qcva
鳈	qfua
尪	wpv
俵	bgui
窬	yj;o
缲	staa
缲	qta
摽	pgei
埏	yfei
鲻	ziua
脒	mkua
粿	glo
钇	ykue
衄	nnu
濞	bmoo
饸	hdua
崟	ys/a
堍	tne
伾	piu
砼	tleu
鲐	taua
阼	z/ai
跞	lmia
鲣	jrua
鹴	speo
瘃	zj;e
锓	qsu
耵	dyei
嶝	dbia
鲚	jmua
瞀	mv/o
挦	xfei
耱	m/ee
礓	jpeu
锎	kque
慭	yzvo
塥	gdei
鲩	hcua
脞	clua
铫	dvue
铫	ygue
夬	gq/
嚆	hti
馇	cqua
篚	fd;
廒	rg;e
捃	jzei
蹯	ffi
讻	xooa
觱	bmvu
锧	zmue
鹙	qo;e
罾	zy/
栴	zrei
叇	dqee
蕹	wbv
脎	squa
桤	qiei
滠	sxoo
蕻	h/vi
箨	t/;e
镤	pjue
洎	jmoo
庳	bm;e
玙	yjee
爝	jdou
髃	yjia
泚	ckoo
筲	st;
萜	tev
劐	hoei
轹	lmea
赆	jzia
鳢	lkua
怊	ctoo
埭	dqei
鹛	mdai
涠	wdoo
痄	zq;e
鹐	qrua
荬	mavi
甾	zq/
橥	zu;a
甓	pm/e
蒟	jjvi
赒	zoia
飗	ll;a
狝	xfua
癀	h;;e
浈	zwoo
谿	xiuo
绠	gha
趼	jfia
杻	clei
杻	nlei
璈	rgee
嵖	caia
箢	yr;e
崞	goia
亸	dlo
镴	lque
鼽	qlui
疰	zn;e
藠	jvv
饳	d/ua
垴	ngei
蒡	bpvi
垡	fa;i
厾	du/
谫	jfoa
镥	ljue
镩	cru
癃	ll;e
撖	hcei
泐	lxoo
筢	pa;e
馘	glou
螬	cgia
玭	pse
璪	zge
枨	chei
湣	msoo
莶	xrvi
砮	nj/u
蒎	pqvi
薤	xxv
邨	cwea
眍	koia
磉	s;eu
憺	dcoo
贳	smvi
菥	xivi
邿	siei
仫	mnui
螵	ptia
舣	ykuu
踒	woia
鸧	cpuo
猹	caua
芼	mvvi
醭	bjei
酤	guei
痃	xf;e
牿	gnue
馉	gjua
蜾	glia
鳣	zrua
岍	qri
铼	laue
勔	mfeu
苠	msv
馌	yxua
诐	bmoa
邲	bmoa
翚	he/o
稃	fuue
馃	glua
鳀	tku
镠	llue
鹡	jkoe
钷	plue
鼷	xiui
簖	dc;e
牮	jc;i
纴	rzaa
墚	l;ei
劁	qtui
鲺	siua
瞫	ssia
碶	qmeu
螗	t;ia
鹎	beu
鳑	p;u
躔	cfia
郛	fjuo
犏	prue
辀	zoea
靿	yve
锫	pdu
蹾	dwia
溍	jzoo
绖	dda
舭	bkuu
汋	zloo
滗	bmoo
毪	mj;e
眵	ciia
腙	zoua
鲊	zaua
侁	swui
拤	qa
脲	nvua
馝	bmue
鳒	jrua
铹	lgue
摅	suei
耥	tpe
钖	y;ue
奓	zqvu
奓	sevu
熜	zlou
瘥	cl;e
瘥	cq;e
阽	yfai
阽	dcai
亹	wd;e
跂	jiia
鲙	kqua
墦	ffei
碥	bfeu
侴	cl;o
伋	jkui
鲿	c;ua
盉	hd;e
弨	ctae
铑	lgue
瘭	bt;e
艴	fjae
鼩	qjui
甗	yfie
莝	c/vi
赇	qlia
楙	mvei
俙	xiui
著	zgvi
著	zevi
恓	xioo
糈	xjou
裛	ym;e
葎	lnvi
鹠	llua
茳	jpvi
澼	pmoo
桯	tye
鲪	jwua
禚	zloa
窎	dv;o
辁	qfea
鼱	jyui
稆	ljue
镈	blue
伣	xcui
侘	cqui
苘	qhvi
脩	xoui
矻	kneu
诇	x/oa
耠	hoee
澥	xxoo
鲏	pkua
蕃	bovi
塆	wrei
螠	ymia
鲘	h/ua
堉	ynei
鲝	za;u
滪	ynoo
综	zbaa
鲾	biu
潟	xmoo
镃	ziue
鳁	wwu
滉	h;oo
斠	jvee
佽	cmui
鲯	qkua
佖	bmui
祾	lhoa
鱾	jkua
螋	soia
霨	wxvo
茀	fjvi
鳠	hnua
椪	pbe
茓	xdvi
喹	kdia
鳡	gfua
祇	qkoa
齉	npu
靰	wnei
栟	bye
槃	pf;u
恁	ns;
轪	dqea
梣	csei
桲	blei
邘	yjee
鳚	wxua
暶	xfia
嵌	kf/
鳤	gfua
滫	xooo
鲕	rdua
淴	huoo
鹲	mhei
劼	jdei
腘	glua
鞧	qoei
榜	pbei
抃	bcei
堃	kw;
鹯	zroe
讱	rzoa
薢	xvvi
蒈	kav
珦	xpee
荮	z/vi
瀵	fzoo
訚	ys;i
溇	lloo
竑	hloe
铻	wjue
醌	kwei
耢	lvee
祐	y/oa
乙	zd//
钘	xhu
疭	z/;e
鹟	wyu
匜	ykva
鲴	gnua
赕	dfia
佸	hlui
鬘	mfvi
罶	ll/a
浕	jzoo
悰	cloo
觏	g/ee
膙	j;u
鹒	gyo
鳛	xkua
铏	xhue
冯	phoe
鳉	jpua
饻	xiua
筻	gp;e
鲬	ylua
猃	xfua
萹	prvi
酏	ykei
鹢	ymou
茚	yzvi
铽	txu
夼	k;v
绹	tgaa
轷	hue
乸	na/i
鳂	weua
蒗	lpvi
傺	cmui
镵	cfue
珺	jzee
琔	dcee
韂	ccei
暲	zpia
耖	cve
蔹	lfvi
鼢	fsu
畤	zmia
郃	hduo
媖	yyau
戤	gqau
侹	thui
绗	h;aa
乾	qfei
