去	q
我	w
在	z
他	t
有	y
是	s
人	r
的	d
也	f
个	g
还	h
就	j
可	k
了	l
想	x
从	c
着	p
不	b
没	m
这	v
你	n
一	yi
来	la
说	so
上	s]
到	db
大	d[
们	mw
道	db;
那	n[
么	me
地	dm
子	zk
下	x[
出	cu
时	sk
看	kv
要	yb
她	tq
中	vo
中	v/
然	rg
里	lk
为	wd
为	wx
过	g/
自	zm
好	hh
得	de
得	dd
会	hc
天	tt
心	xw
后	h/
以	yk
小	xh
都	do
和	hd
对	dc
能	nf
起	qk
之	vi
手	sl
而	rk
只	vi;
只	vk
生	sr
使	sk;
身	sw
头	tl
样	y]
事	sm
多	do;
己	jk
家	jq
面	mv
知	vi/
开	kq
如	rj
无	wj
现	xv
很	hs
点	dg
前	qg
发	fq
发	f[
经	jr
情	qf
把	ba
老	lh
些	xe
话	h[
已	yk;
又	y/
声	sr;
意	ym
于	yj
回	hf
笑	xb
所	sl;
但	dv
眼	yg
成	cf
方	fp
年	ng
见	jv
当	dp
女	nj
真	vw
两	l;
力	lm
气	qm
用	y/;
长	c;
长	v;
动	d/
间	jt
间	jv;
国	gl
走	zl
让	r]
被	bx
给	gd
正	vc
问	wz
打	da
明	mf
儿	rk;
法	fa
才	ca
几	jk;
行	h;
行	xf
三	st
定	dc;
此	ck
进	jz
再	z[
种	vl
将	jp
实	sk/
同	tl;
最	zc
本	bs
向	x]
分	fw
十	ske
学	xa
高	gy
第	dm;
感	gg
怎	zs
神	ss
听	tr
边	bt
作	z/
其	qk;
吧	bq
却	q[
口	kl
觉	ja
啊	rq
因	yw
白	ba;
次	cm
军	jw
做	z/;
外	w[
门	ms
光	gp
风	fr
主	vj
住	vn
果	gl;
与	yj;
全	q;
二	rm
候	h/;
公	go
相	xp
相	x];
吗	mq
等	df
别	bd
色	sx
死	ske;
张	vp
部	bn
太	t[
日	rm;
少	sh
少	sb
战	vv
理	lk;
直	vk;
重	cl
重	v/;
王	w;
像	x]/
脸	lg
比	bk
快	k[
何	hd;
水	sf
名	mf;
体	tk
呢	ne
东	do/
叫	jb
西	xi
应	yr
应	yc
便	bv
便	pg
放	f]
马	ma
难	ng;
轻	qr
更	gc
美	md
位	wx;
关	gp;
机	ji
接	je
先	xt
文	ws
处	cj
处	cn
并	bc
望	w]
常	c;;
完	wg
四	sm;
飞	fe
师	si
者	vd
安	rt
清	qr;
刚	gp/
跟	gw
月	y[
信	xz
山	st;
爱	r[
内	nx
龙	ll
空	ko
空	k/
带	d[;
找	vh
原	y;
入	rn
李	lk/
连	lg;
吃	ci
场	c;/
平	pf
思	si;
林	ls
变	bv;
什	ss;
由	yl
受	s/
亲	qw
命	mc
目	mn
强	q;;
男	ng/
任	rz
该	gq
路	ln
车	ce
今	jw;
海	ha
加	jq;
远	y;;
活	hl
特	tx
解	jd
电	dv;
世	sm/
性	xc
表	bh
许	xj
它	tq;
立	lm;
黑	he
金	jw/
红	hl;
花	hq
转	v;;
转	v]
总	zl;
算	s];
城	cf;
队	dc/
孩	ha;
反	fg
工	go;
始	ska
满	mg
新	xw;
兵	br
物	wn
离	lko
非	fe;
虽	sr/
云	ys
似	smu
万	wv
至	vm
干	gt
干	gv
通	to
认	rz;
失	si/
火	hl/
哥	ge
士	sme
五	wj;
惊	jr;
魔	ml
竟	jc
姐	jd;
乎	hu
剑	jv/
往	w;;
量	l;;
量	l]
早	zh
结	jd/
怕	p[
流	ll;
突	tu
坐	z//
斯	sie
音	yw;
紧	js
指	vk/
拉	lq
杀	sq
半	bv/
记	jm
且	qd
利	lm/
合	hd/
倒	dh
倒	db/
书	su
度	dn
微	we
步	bn;
教	jy
教	jb;
喜	xk
越	y[;
影	yf
谁	sd
冷	lf
深	sw;
告	gb
落	l/
象	x]u
容	rl
怪	g[
传	c;u
传	v];
钱	qg;
提	tk;
言	yg;
随	sf;
每	md;
双	sp
服	fj
击	ji;
武	wj/
哪	na
数	sj
数	sn
站	vv;
奇	qk/
房	f;
管	g;
灵	lf;
刻	kx
题	tk/
衣	yi;
周	vo;
静	jc;
伤	sp;
百	ba/
拿	na;
妈	mq;
办	bva
星	xr
化	h[;
功	go/
绝	ja;
系	xm
般	bt;
必	bm
业	yx
尔	rk/
件	jvu
血	xd
血	x[;
代	d[/
精	jr/
弟	dm/
终	vo/
近	jz;
条	th
青	qr/
界	jx
司	sia
整	vf
欢	hp
字	zm;
晚	wg;
民	ms;
帮	bp
切	qe
切	qx
即	jk/
忙	m;
交	jy;
或	h//
暗	rv
夫	fu
员	y;/
根	gw;
石	ske/
哈	hq;
夜	yx;
父	fn
制	vm;
友	yl;
阿	rq;
息	xi;
冲	co
酒	jl
保	bh;
片	pv
形	xf;
阵	vz
南	nge
决	ja/
请	qf;
各	gx
报	bb
兴	xr;
兴	xc;
阳	y;a
急	jku
语	yj/
令	lc
错	c/
及	jka
刘	ll/
极	jke
识	sko
备	bx;
慢	mv;
雪	xa;
苦	kj
若	r/
领	lf/
收	so;
底	dk
尽	jz/
准	vs
看	kt
华	ha/
华	h[/
答	da;
众	v//
千	qt
要	yy
消	xy
视	smo
罗	lli
敢	gg;
留	llu
克	kx;
乐	lx
乐	y[/
够	g/;
跑	ph
显	xg
嘴	zf
官	gpo
断	d]
未	wx/
势	sme;
句	jn
求	ql
计	jm;
论	lz
达	da/
则	zd
害	h[o
八	bq;
单	dt
久	jl;
脚	jh
德	dd;
元	y;e
脑	nh
楚	cj;
雨	yje
睛	jri
响	x;
刀	dy
确	q[;
玉	yn
得	dd/
沉	cs
北	bd;
格	gd;
停	tf
陈	cs;
市	smo;
朝	vy
朝	ch
喝	he;
族	zj
江	jp;
团	t;
母	mj
章	vp;
装	vp/
亮	l];
客	kx/
照	vb
乱	l]/
易	ym;
足	zj;
依	yi/
黄	h;;
修	xo
破	p/
台	ta
球	ql;
呀	yq
院	y];
送	s/;
包	by
义	ym/
诉	sn;
攻	goe
丝	sia;
围	wd;
玩	wg/
待	dq
待	d[u
复	fn;
况	k]
楼	lle
丽	lme
痛	t/
梦	mc;
呼	hu;
摇	yh
期	qke
英	yr;
低	di
帝	dmo
兄	xo;
背	be
背	bx/
持	ck;
爷	yd
皇	h;/
七	qi
六	l/;
穿	cp
都	du
杨	y;e;
政	vc;
运	yz
居	ju
叶	yx/
热	rx
校	jb/
校	xb;
谢	xx
曾	cf/
古	gj
细	xm;
产	cg
睡	sc
希	xi/
速	sn/
室	smo/
旁	p;
另	lc;
怀	hao
露	ln;
异	yma
写	xd;
鬼	gf
娘	n;
取	qj
式	sme/
除	cj/
级	jka;
考	kh
建	jva
愿	y]/
招	vy;
饭	fv
布	bn/
续	xn
程	cfu
首	sl/
观	gpa
朋	pf;
务	wn;
掉	dbe
赶	gg/
忽	hu/
注	vn;
术	sne
甚	sz
差	cq
差	c[
呵	he/
展	vg
争	vr
品	ps
兰	lg/
宝	bh/
香	xp;
斗	d/;
故	gn
雷	ld
念	nv
段	d];
顿	dz
角	jh;
角	jau
疑	yk/
护	hn
闪	sg
木	mn;
需	xu
调	dbo
调	th;
类	lx;
妹	mx
爸	b[
线	xv;
左	zl/
游	yl/
派	p[;
谈	tg
激	ji/
冰	br;
敌	dk;
跳	tb
支	vie
约	yq;
巴	bq/
您	ns
顾	gn;
肯	ks
醒	xf/
铁	td
抱	bb;
淡	dv/
造	zb
伙	hlu
资	zi
群	qs
集	jku;
联	lge
商	sp/
号	hh;
号	hb
节	jde
讲	j;
掌	v;/
赵	vb;
密	mm
九	jl/
病	bc;
卫	wxa
米	mk
威	we;
继	jm/
渐	jvo
统	tl/
追	vr;
亚	y[e
简	jg
练	lv
基	jie
选	x;;
推	tr;
改	ga
退	tc
味	wxi
份	fz
举	jj
示	smee
忍	rs
历	lme;
器	qm;
恐	kl;
引	ys;
试	smoa
皮	pk
习	xk;
靠	kb
导	dh;
存	cs/
莫	m/
志	vm/
区	qu
汉	hv
右	y//
严	yg/
态	t[;
买	ma;
幸	xc/
社	sx;
佛	fl
佛	fj;
议	ymo
树	sne;
止	vki
块	k[;
守	slo
毛	mh
挥	hr
胡	hj
散	sg;
散	sv
板	bg
仅	js;
隐	ys/
怒	nn
床	c;o
苏	su;
料	lb
股	gj;
局	jj;
班	bt/
图	tj
岁	sc;
礼	lko;
独	dj
初	cu;
福	fj/
顺	sz;
狂	k;
默	m/;
巨	jn;
既	jma
松	so/
证	vc/
烈	lx/
否	fl;
恶	rd
恶	rx;
恶	wn/
治	vmo
缓	h;a
排	pa
费	fx
拍	pq
耳	rke
医	yie
寒	hg
哭	ku
温	ww
府	fjo
担	dt;
担	dve
称	cz
称	cr
称	cc
余	yju
钟	vou
泪	lxo
烟	yt
仍	rf
具	jn/
忘	w];
恩	rw
毕	bm;
警	jf
蓝	lge;
宫	goo
吸	xii
陆	ln/
究	jo
抓	vq
压	yq/
沙	sq;
救	j/
呆	dq;
河	hdo
迷	mk;
枪	qp
组	zj/
权	q;/
叹	tv
孙	sw/
卷	j;;
查	ca;
毫	hh/
春	cw
察	ca/
圣	sc/
草	ch;
较	jbe
胜	scu
遇	yn;
充	co;
史	ski
堂	t;;
防	f;;
据	jne
猛	mf/
骑	qka
土	tj;
卡	ka
助	vn/
京	jro
银	ysu
贵	gc;
永	ylo
质	vmu
屋	wu
须	xu;
副	fn/
换	h]
刺	cm;
属	sj;
闻	ws;
境	jc/
禁	jwe
禁	jze
阴	yw/
共	g//
负	fnu
弄	n/
翻	ft
虎	hj;
层	cfa
喊	hg;
逃	th/
晓	xh;
座	z/o
雅	ya
参	ct
射	sx/
婚	hw
险	xg;
君	jwa
划	h[e
坚	jt;
价	j[
柔	rl;
超	cy
扬	y;e/
科	ke
按	rv;
狠	hs;
野	yd;
秦	qs;
秘	mm;
熟	slo;
熟	sj/
置	vmi
仙	xt;
模	ml;
模	mj;
伸	swu
波	bo
肉	r/;
假	jau;
假	j[;
齐	qko
舞	wju
脱	to;
广	g;;
姑	gu
麻	ma/
投	tle
顶	df;
致	vme
责	zd;
景	jf;
营	yf;
维	wd/
设	sxo
坏	h[e;
啦	lq;
秀	x/
败	b[;
眉	md/
州	voo
药	yb;
承	cfa;
案	rv/
狼	l;/
专	vpe
偷	to/
画	h[e/
吴	wji
店	dvo
哦	r//
弹	dva
弹	tg;
食	sku
欲	yn/
抬	ta;
标	by;
秋	qo
厉	lme/
良	l;o
际	jma;
状	v]/
烦	fg;
午	wju;
摆	bae
戏	xm/
桌	voi
船	c;u;
短	d;
村	cw;
某	ml/
摸	mo
付	fnu;
演	ygo
规	gr
萧	xy;
封	fr;
握	w/
田	tg/
唐	t;/
藏	c;e
震	vz;
混	hs/
混	hz
虚	xu/
透	t/;
纪	jma/
凌	lfo
休	xo/
嘛	mq/
梅	mde
紫	zk;
歌	ge;
临	ls;
毒	dj;
宗	zo
著	vne
索	sle
印	yz;
寻	xs
湖	hj/
劲	jza
职	vke
技	jme
恨	hz;
婆	pl
杰	jde;
羽	yja
咱	zg
素	sne/
凡	fg/
值	vku
飘	py
养	y;o
嘿	hei
普	pj
宁	nf;
宁	nc
吓	x[/
兽	s//
夏	x[e
读	dj/
街	je;
牛	nl
仿	f;/
胸	xou
浪	l]o
富	fno
尚	s]/
宇	yjo
骨	gj/
智	vmu;
纷	fw;
升	sru
叔	su/
善	sv;
弱	r/a
架	j[/
卖	m[
袋	d[u;
网	w;/
朱	vu
骂	m[;
雄	xl
赛	s[
略	l[
杯	be;
施	sio
墙	q;e
环	h;e
罪	zc;
牙	ya;
窗	cp;
柳	lle;
厅	tr/
搞	gh
端	dp;
洞	d//
适	smu;
拥	yo
释	smu/
洋	y;o;
肩	jt/
魂	hse
闹	nb
蒙	mr
蒙	mfe
蒙	mfe;
洗	xk/
灯	dr
借	jx;
伯	bl
免	mg;
菜	c[;
验	yv
凤	fc
鱼	yju;
徐	xj;
型	xfe
娜	n[;
娜	nl;
暴	bb/
亡	w;o
讨	tho
辈	bxi
懂	dl
腿	tf;
灭	mx;
妙	mb
效	xb/
危	we/
优	yo;
盘	pg;
套	tb;
丁	dr;
趣	qn
妖	yy;
束	snei
杂	za
诗	sio;
迎	yf/
舍	sd;
旧	j/;
彩	cau
委	wdu
挂	g[;
笔	bk;
狗	gl/
鲜	xt/
鲜	xg/
纸	vka
抗	k];
探	tv;
韩	hg/
尼	nk
控	k/;
惜	xko
珠	vu;
抽	co/
创	cp/
创	c]
归	gr;
挺	tf/
奋	fz;
陪	pd
硬	yc;
避	bm/
园	y;i
托	toe
训	xz;
勇	yla
聊	lh;
种	v/u
奶	na/
庄	vpo
奔	bw
奔	bz
镇	vz/
拳	q;o
采	cau;
研	yge
将	j]
配	px
介	jx/
尊	zw
冒	mb;
虑	lni
敬	jce
丹	dt/
舒	suu
蛋	dva;
哼	hr;
宋	s/o
济	jmo
妇	fna
箭	jvu;
择	va
择	zd/
犯	fv;
欣	xw/
甲	jai
欧	ro
课	kxo
扑	pu
菲	fe/
菲	fd
燕	yv;
曲	qu;
曲	qj;
躲	dl;
玄	x;/
幻	h];
茶	cae
折	vd;
折	sd/
伊	yiu
傻	sa
姓	xca
源	y;o/
洛	l//
遍	bvo
臣	cse
弃	qm/
犹	ylu
占	vt
占	vv/
漂	py;
漂	ph;
漂	pb
挑	ty
挑	the
获	h/e
绿	lna
峰	fr/
俊	jzu
疯	fro
列	lxe
作	zo;
森	swe
妻	qi;
恋	lv;
误	wno
拜	b[/
伟	wdu;
移	yku
纳	n[/
党	d;;
罢	b[i
腰	yy/
巧	qh
孤	gu;
闭	bmo
圆	y;i;
碰	pc
镜	jcu
软	r;
厚	h/e;
累	ld;
累	lxi
昨	zli
幽	yo/
悲	be/
丈	v]e
牌	pa;
降	j];
降	x;a
颜	ygo;
劳	lh/
偏	pt
省	sf/
省	xfi
糊	hjo
糊	hn;
馆	g;/
烧	sy
谓	wxo
财	cai
舰	jvu/
汗	hgo
汗	hv;
奈	n[e
操	cy;
迹	jmo;
尸	sia/
悄	qh;
残	cg;
尖	jti
鲁	lj
锋	fru
圈	j]/
圈	qp;
油	ylo;
俩	la;
项	x]e
撞	v]e;
瞬	sz/
忆	ymo;
盖	g[/
尤	yle
徒	tj/
乡	xp/
概	g[e
户	hn/
荡	d]/
艺	yme
增	zr
祖	zjo
困	kz
殿	dva/
迅	xz/
横	hf;
横	hc;
范	fv/
律	lnu
番	ft;
企	qku
惨	cg/
限	xv/
聚	jne;
含	hgu
凭	pf/
剧	jna
碎	sce
躺	t;u
缘	y;a;
凉	l;o;
腾	tfu
织	via
抢	qp/
抢	q;e;
预	yna
沈	ss/
替	tm
孔	kl/
批	pi
康	kp
惑	h/e/
唯	wdi
率	lno
惯	g]
登	dr/
互	hne
盯	dri
稍	sy;
宣	xpo
唱	c];
诚	cfo
剩	scu;
咬	yh;
育	yno
诸	vu/
触	cn;
晨	csi
策	cx
疼	tfo
漫	mv/
材	cae;
补	bj
私	siu
吐	tji
吐	tn
纯	csa
艾	r[;
贝	bxi;
谷	gju
庭	tfo;
挡	d;/
晃	h;i
晃	h]/
吉	jke;
吹	cr;
仔	za;
仇	cl;
凝	nf/
鼓	gje
农	nl/
席	xko;
征	vr/
帅	s[;
附	fna;
缺	qq
塞	sq/
塞	s[/
塞	sxo;
豪	hho
亦	ymo/
杜	dn;
努	nj;
判	pv;
谋	mlo
胆	dg;
尘	csi;
扎	vq;
滚	gs
闷	mw;
闷	mz
迟	ck/
稳	ws/
翼	yma;
诺	n/;
闲	xgo
灰	hr/
朵	dl/
盛	cfe
盛	sce;
梁	l;o/
晶	jri;
餐	ct;
好	hb;
爆	bbo
伦	ls/
娇	jy/
侧	cx;
愣	lc/
鼻	bk/
轮	lse
昏	hw;
抖	dle
陷	xva
敏	ms/
词	cko
慌	hp;
愤	fz/
怜	lgo
颤	cv
阶	je/
苍	cpe
距	jni
郑	vco
川	cpu
扫	sh;
扫	sb;
逼	bi
县	xvi
忧	yoo
童	tlo
执	vke;
丢	dou
荣	rl/
臂	bma
逐	vj;
傲	rb
戴	d[e
芒	m;;
庆	qc
伴	bvu
袭	xke
供	gou
供	g/u
积	jiu
测	cx/
遥	yh/
阻	zja
例	lmu
睁	vri
岛	dh/
遗	yki
瞪	dci
慕	mn/
皱	v/u;
博	bl;
幕	mne
猜	cq;
益	ymou
净	jco
泽	zdo
炼	lv/
监	jti;
鸡	jia
珍	vw;
伏	fju
绍	sb/
曹	ch/
爬	pa/
丫	yqo
炸	va;
炸	v[
壁	bma;
涌	ylo/
凶	xou;
郎	l;oa
宿	sno
宿	xl;
宿	x/;
怨	y]u
醉	zc/
拼	pw
迫	p/;
革	gd/
瞧	qh/
奥	rb;
输	sue
莉	lmei
忠	voi;
颗	ke;
嗯	rw;
佳	jq/
旅	lj;
仁	rs;
鸟	nh;
骗	pv/
浩	hb/
塔	ta/
胖	p]
绪	xn;
枫	fre
拔	bae;
赞	zv
炮	pb;
傅	fnu/
凯	ka;
邪	xd/
芳	fp;
浑	hso
夺	dle;
宽	kp;
堆	dre
裂	lxe;
遭	zy
赤	cm/
旋	x;o
旋	x]o
扭	nle
洁	jdo
浮	fjo;
悉	xiu
难	nv;
擦	cq/
慧	hc/
典	dg/
赏	s;
匆	cou
评	pfo
纵	z/a
莲	lge/
雾	wne
乌	wu;
跃	y[i
壮	v]o
贴	te
丰	fre;
隔	gda
健	jvui
辛	xwo
抵	dk/
竹	vj/
彻	cxu
摩	mlo;
轰	ho
编	bta
肚	dju
肚	dn/
插	cqe
磨	mlo/
磨	m//
哎	rq/
御	ynu
耐	n[e;
惧	jno
氏	smua
辉	hri
扶	fje
恢	hro
貌	mb/
额	rd;
述	snei;
票	pb/
录	lna;
拖	toe;
膀	b;
膀	p;;
鹰	yr/
孟	mc/
递	dmo;
瑞	rc
唇	cse;
暂	zv;
货	h/u
琴	qs/
踪	zo/
码	mae
慰	wxa;
蛇	sdi
玲	lfe
晕	ywi
晕	yz/
损	sse
轩	xpe
粗	cu/
掩	yge;
屁	pm
悠	you
仰	y;u
零	lfe;
盟	mfi
途	tju
贼	zdi
洪	hlo
悟	wno;
固	gn/
讶	y[o
冬	dou;
滑	hao;
甜	tgu
郁	yne
琳	lse;
辆	l]e
乃	naa
猪	vuu
暖	n;;
妮	ni
挣	vre
挣	vce
旦	dvi
估	gu/
坦	tge
甘	gt;
佩	px;
莱	la/
享	x;o;
吼	hli
构	g/e
粉	fs
萨	s[e
吻	wsi
潜	qg/
瓶	pfo;
偶	rlu
戒	jxe
浓	nlo
毁	hf/
销	xy/
迪	dki
拒	jne/
绕	rb/
勒	lxe/
勒	le
朗	l;oa;
嘻	xii;
尾	wda
尾	yka
帐	v]i
废	fx;
延	ygu
敲	qy
烂	lvo
曼	mvi
厌	yv/
宜	yko
羞	xoo
喂	wxi;
吟	ysi
滴	di;
洲	voo;
爹	de;
艳	yve
晴	qf/
抚	fje;
缩	soa
协	xde
央	yp
悔	hfo
肖	xyi
肖	xbi
缠	cga
脆	cc;
痕	hso;
伍	wju/
寂	jmo/
启	qko;
翔	x;o/
薄	bhe
薄	bl/
薄	b/
侯	hlu;
劝	q]
郭	goo;
奴	nj/
鸣	mfi;
倾	qru
彼	bku
扔	rr
撒	sqe
撒	sa;
豫	yna;
检	jg;
针	vw/
耀	yb/
痴	ci;
姆	mj/
篇	pt;
椅	yke
厂	c;e;
董	dle/
熊	xl/
埋	mae;
乖	gq;
狐	hju
蒋	j;/
踏	t[/
隆	lla
括	k//
潮	cho
唉	r[/
穷	ql/
聪	coe
唤	h]i
泰	t[e
版	bg;
末	m/e
旗	qko/
仪	yku;
焦	jyu
猫	my
盗	dbo;
侍	smui
挤	jke/
款	k;;
拾	skei
荒	hp/
强	q;a
姿	zi;
域	yne;
搭	dq/
脉	m[/
脉	m/u
授	s/e
俗	sju
融	rle
狱	ynu;
欺	qi/
访	f;o
桥	qhe
锁	slu
霸	b[e
牵	qt;
池	cko;
钻	zp
钻	z]
港	g;o
喃	ngi
廷	tfu;
乘	cfu;
玛	mae/
奉	fc;
扯	cd
岳	y[u
减	jg/
弯	wt
夹	jae
辞	cku
岸	rvi
岂	qki
屈	qu/
恼	nh/
哲	vd/
季	jmu
召	vb/
丧	spe
丧	s]e
尝	c;i
恭	goe;
载	za/
载	z[;
瘦	s/o;
皆	jee
颇	po
茫	m;/
染	rg;
肃	sna
爽	s;;
亏	kr
吞	tw
惹	rd/
哀	rqo
乔	qhu
趁	cz;
铺	pu;
铺	pn
脏	zp;
吕	lj/
奖	j;o
倍	bxu
汤	tp
振	vze
婷	tfa
牢	lho
扰	rh
溜	lo
溜	l/o
庞	p;/
臭	c/;
悦	y[o;
赫	hx
赢	yfo
跪	gc/
麦	m[e
枝	vie;
侠	xa/
泉	q;u
劫	jde/
炎	ygo/
泥	nk;
赌	dji
弓	goa
魏	wxu
罩	vbi
疾	jko
饰	smua;
符	fju;
垂	cfu/
映	yc/
漠	m/o
脖	blu
饮	ysu;
沿	ygoo
懒	lgo;
肤	fu;
桑	spa
堪	kt;
燃	rg/
卓	vl;
祝	vno
赖	l[;
宾	bw;
贾	jae;
喘	c;i;
焰	yvo
吵	chi
冥	mfo
鞋	xde;
逸	ymu
均	jwe;
库	kn
裤	kn;
碗	wge
航	h;u
踢	ti
姨	yka;
酸	spe;
啸	xbi;
龄	lfi
阁	gdo
舌	sdu
箱	xpu
冯	ff
邦	bp;
钢	gpu
霞	xae
促	cn/
泡	pbo
盾	dz;
羊	y;ou
碧	bme
援	y;ei
忌	jmae
结	jea
抹	mle
抹	m/e;
倩	qv
锐	rc;
喷	pw;
拦	lgei
嘉	jqe
袖	x//
殊	sue;
辰	cse/
繁	fgu
络	l/a
抛	py/
嫁	j[a
咒	v/i
撤	cxe
键	jvue
湿	sio/
恰	q[/
虫	cl/
审	sso
献	xve
媚	mx/
贤	xgi
葛	gde
刹	squ
刹	c[/
袁	y;ei;
摔	sqe;
序	xn/
筑	vnu
斜	xdu
瓦	wa
涂	tjo
湾	wt;
莎	sqe/
崇	cli
猎	lxu
刑	xfe;
墨	m/i
娃	wa;
梯	ti;
桃	the;
豆	d/e
驾	j[a;
浅	qgo
径	jcu;
饿	rx/
疲	pk;
搬	bte
瓜	gq/
莹	yfe
滋	zi/
润	rz/
铃	lfu
蛮	mg/
蒂	dme
拨	bo;
涛	ty;
予	yja;
勾	gou;
惠	hce
析	xie
落	l[/
落	lb;
砍	kg
撑	cr/
截	jdei
措	c//
币	bmu
薇	wee
愈	ynu/
督	du;
酷	kn/
祥	x;oa
怖	bno
侵	qw;
岩	ygi
扮	bve
糟	zy;
盈	yfa
腹	fnua
斩	vg;
尺	cka
签	qt/
稀	xiu;
掏	ty/
夸	kq;
汽	qmo
液	yxo
姬	jia;
愧	kc
汇	hco
柱	vne;
粮	l;ou
堡	bhu
仗	v]u
笨	bz;
奏	z/e
歉	qv;
甩	sa/
怔	vco;
允	ysa
竞	jco;
祸	h/o
耶	ye
耶	yd/
爵	jau/
绩	jmaa
诱	y/o
呜	wu/
穴	xao
黎	lku
租	zu
培	pd;
砸	zae
井	jf/
窝	wo
弥	mk/
返	fgu;
匹	pk/
啥	sai
凑	c/o
奸	jta
陌	m/a
叛	pvo
核	hde
核	hje
卧	w/;
幅	fji
眨	va/
耗	hbe
洒	sao
怡	yko;
详	x;oa;
卢	lji
扣	k/e
哇	wq
丑	cla
勉	mgu
孝	xbe
矛	mh;
氛	fw/
衡	hfu
陶	tha
购	g/i
汪	wp
僵	jp/
疗	lho;
妃	fea
罚	fa;
系	jmu;
棋	qke;
缝	ff;
缝	fc/
咐	fni
躯	quu
泛	fvo
愁	clu
血	x[u
搜	soe
慈	cko/
肥	fd;
笼	llu;
篮	lgu
俱	jnu
惟	wdo
柜	gce
捉	voe
悬	x;i
霍	h/eo
泄	xx;
咽	yt;
咽	yvi
齿	cki
秒	mh/
勤	qse
扩	k/e;
屏	bf
屏	pfa
霜	spe/
袍	ph/
蝶	ddi
祭	jmu/
夫	fje/
厨	cje
胁	xdu;
璃	lke
劈	pi;
赚	v]i;
锦	js/
尬	g[e;
尴	gt/
熙	xie;
寺	smei
昌	cpi
贺	hx;
巾	jwi
描	mhe
捕	bj;
陵	lfa
咳	kd
扇	st/
扇	sv/
虹	hli;
绵	mga
撕	sie;
蔡	c[e
催	cru
彭	pfe
宠	clo
贪	tt;
辱	rj;
誓	smei;
盒	hdu
寸	cz/
披	pi/
搂	lo;
搂	lle/
饶	rh;
跌	de/
欠	qv/
肌	jiu;
售	s/u
巡	xs;
抑	yme;
纹	wsa
宏	hlo;
幼	y/a
萍	pfe;
驻	vna
丛	clu;
亿	ymu;
播	bo/
俄	rdu
刃	rza
蕾	ld/
挨	rqe
仲	v/u/
迈	m[e;
违	wde
辩	bvo;
埃	rqe;
艘	sou
琪	qke/
灾	zq
僧	sru;
渡	dno
卑	beu
雕	dy;
鼠	sju;
讯	xzo
辣	l[o
刷	sqa
艰	jta;
斥	cmu
裙	qso
翠	cc/
饱	bhu;
掠	l[e
询	xs/
勃	ble
夕	xku
矮	ra
瑶	yhe
赐	cmi
捏	ne;
闯	c;o;
姚	yha
瑟	sxe
渴	kd;
谅	l]o;
昂	r;;
串	c]/
沟	goo/
涉	sxo/
咕	gui
驶	ska;
摄	sxe;
贫	ps;
辕	y;ea
婉	wga
答	dqu
鹏	pfu
姜	jpo
碍	r[e
荷	hde;
荷	hx/
冠	gpo;
冠	g];
魅	mxu
玫	mde;
裁	cae/
坡	po;
鸿	hlo/
邓	dca
歪	wq;
乏	fa/
申	swi
割	ge/
巫	wue
衫	sto
棒	b]
阔	k/o
泣	qmo;
韦	wde;
恍	h;o
贯	g]/
魄	p//
柄	bf;
患	h]i;
覆	fne
蜜	mm/
婴	yri
励	lmeu
锅	gou/
陛	bma/
遮	ve
帕	p[/
咖	gqi
咖	kq/
嫌	xga
胳	geu
挖	wq/
啪	pq;
矿	k]/
凄	qio
爪	vh;
爪	vau
眠	mgi
穆	mnu
啡	fei
吾	wje
坛	tge;
脾	pku
恒	hfo;
屠	tja
玻	boe
蓉	rle;
础	cje;
曰	yqi
耸	slu;
膊	blu;
逆	nm
寿	s/e;
驱	qua
猴	hlu/
佣	y/u
毅	ymoe
舅	j//
铜	tlu
娟	jpa
眯	mki
淫	yso
吩	fwi
匪	fd/
牧	mnu;
役	ymu/
寄	jmoo
诡	gf;
纤	xta
腐	fjo/
姻	ywa
晰	xii/
渊	yp;
亭	tfo/
邀	yyu
哄	ho;
哄	hli/
骚	sy/
墓	mne;
柯	ke/
筋	jwu
崔	cri
灿	cv;
捷	jdei;
淋	lso
弗	fja
辑	jkea
棍	gz
绳	sfa
喝	hxi
频	ps/
廊	l;oe
畏	wxi/
歇	xe;
裹	glo
苗	mhe;
盼	pvi
咯	gei
咯	lo/
咯	l/i
耍	sae
煞	s[u
寝	qso;
瞒	mgi;
添	tt/
嫂	sh/
纠	jo;
慨	ka/
嚷	r;/
驰	cka;
拐	ga;
宴	yvo;
津	jwo
岚	lgi
浴	yno;
耻	cke
挽	wge;
页	yxe
誉	yno/
牲	sru/
乳	rj/
仓	cpu;
逝	smei/
喉	hlia
逛	g]u
樱	yre
兼	jto
戈	gee
哗	hq/
哗	hai
会	k[/
涯	ya/
捧	pfe/
铭	mfu
障	v]a
摊	tte
跨	k[i
妥	tlu;
揉	rle/
晋	jze;
寞	m/o;
寨	v[;
漆	qio;
污	wuo
嘲	chi;
枚	mde/
吊	dbi
乾	qge
馨	xwe
伪	wdu/
嗓	s;/
呈	cfi
卿	qru;
楠	nge;
籍	jku/
裸	llo
链	lvu
灌	g]o
昆	kw
畅	c]i
逍	xyi;
帽	mbi
阅	y[o/
逗	d/e;
蹲	dw
踩	cai;
窜	c]o
哑	yai
趴	pq/
逢	ff/
植	vke/
媒	mda
韵	yzo
昭	vy/
尹	ysa;
谦	qto
档	d]e
趟	tp;
趟	t]
沾	vt;
兔	tn;
订	dco
朴	pj;
瞎	xq
鞭	bte;
俺	rgu
斤	jwu;
翅	cme
肠	c;u/
雀	qy;
雀	qhi
雀	q[i
慎	szo
盆	psu
迁	qtu
镖	by/
芬	fwe
崖	yai;
丘	qo;
蠢	csee
庙	mbo
潘	pt/
颖	yfu
拓	t//
娶	qj/
纱	sqa;
漏	l/o;
谨	jso
珊	ste
和	hxu
仆	pj/
曾	zr;
宙	v/o
尉	yna/
屑	xx/
叮	dri;
捂	wje;
涩	sxoo
诧	c[o
柴	cai/
杆	gte
杆	gge
涵	hgo;
坠	vca
赔	pd/
涨	v;o
涨	v]o;
嘟	du/
崩	br/
薛	xq;
藤	tfe
税	scu/
枯	ku;
译	ymoa
帘	lgo/
糖	t;o
愉	yjo;
骄	jya
羡	xvo
糕	gy;
彬	bw/
愚	yji
疏	sua
翰	hv/
堵	dje
腕	wv;
眸	mli
芸	yse
溪	xio
殷	ywu
谎	h;o;
鼎	df/
稿	gh;
哟	yoi
冤	yp/
症	vro
症	vco/
棵	kee
狄	dku
咧	ldi
湘	xpo;
宛	wgo
嫩	nz
肆	smeie
宰	zao
憾	hvo
偿	c;ui
腔	qpu
哩	li
豹	bbu
瑰	gr/
鉴	jvi
绑	b;;
潇	xyo
戚	qie
郡	jza;
澡	zh;
桂	gce;
兮	xiu/
雯	wse
颠	dte
狮	siu;
邻	lsu
契	qme
骇	h[a
卜	boi
卜	bj/
差	cqo
揭	jee;
妄	w]/
坑	kr;
伐	fau
矩	jj/
烁	s/o/
葬	z];
诀	jao
鄙	bki
鹿	lno;
柏	bae/
柏	ble;
溃	kc;
朕	vzu
舟	vou;
妆	vpo;
躁	zb;
霉	mdeo
侦	vwu
冻	d/o
娅	y[a
庸	yoo;
筹	clu/
削	xyi/
削	xq/
砰	pr
耿	gf/
牺	xiue
筒	tlu/
遂	sco
旭	xnu
胎	tq/
惶	h;o/
淑	suo
叉	cqa
痒	y;oe
竖	sni
龟	gru
斑	bte/
儒	rju
嫣	yt/
宅	vao
押	yqe
胃	wxia
旨	vku;
册	cxu;
膝	xiua
浸	jzo
弦	xga;
栏	lgei;
衷	voo/
刮	gqu
艇	tfu/
岗	g;i
赴	fne;
囊	n;/
斧	fju/
颊	jae/
疆	jpa;
炉	ljo
塌	tqe
乞	qku;
旺	w]i
烤	kh;
黛	d[u/
逊	xza
贱	jvi;
辨	bvo/
狸	lku;
叙	xnu;
愕	rxo
叠	dda
遣	qgi
晌	s;i
麟	lso;
腥	xr/
粒	lmo
拟	nk/
俏	qb
杖	v]e/
芝	vie/
夷	yke;
衬	czo
佐	zlu
巷	x]e;
捡	jge
遵	zw;
塑	sno;
桶	tle;
泼	po/
滩	tto
琼	qle
昊	hbi
帆	ft/
搏	ble/
颈	jfa
噢	ro;
蹦	bc/
寡	ga/
贞	vwi
凰	h;u;
哨	sbi
拆	cqe;
茹	rje
劣	lxi;
嘱	vji
沃	w//
厢	xpe;
摘	vq/
咋	v[/
咋	zai
咋	zdi;
坤	kw;
俯	fjui
媳	xka
赋	fni;
嘶	sii
贡	g/e;
碌	lne
匙	cki;
拢	llei
谭	tgo
翁	wr
辜	gue
竭	jdo;
廉	lgoe
械	xxe
贸	mbu
辅	fjea
讽	ffo
呐	n[i
斌	bwo
辽	lha
填	tge/
窃	qx;
抄	cy/
溢	ymoo
妒	dna
吁	xui
吁	yni
嗦	soi
掀	xte
芙	fjei
祈	qkoa
栋	d/e/
吱	vii
撇	pe
撇	pde
胞	byu
轿	jbe;
禅	cgo
禅	svo
妨	f;a
拂	fjei;
倦	j]u
衰	sqo
靖	jco/
循	xsu
挪	nle;
蓬	pfei
惩	cfuu
垃	lq/
账	v]i/
驳	bla
署	sji
甫	fjei/
顽	wge/
姥	lha;
圾	jie;
熬	rh/
枕	vs;
丐	g[e/
茜	qve
咦	yki;
厕	cxe;
攀	pte
彤	tlua
妍	yga
拽	v[e
荆	jre
妓	jmau
壶	hje;
寇	k/o;
鹤	hxo
钥	ybu
骤	v/a
渺	mho
刊	kt/
肢	viu
烛	vjo
孕	yza
绽	vva
彦	yvo/
棉	mge
俘	fjui;
盔	kr/
剪	jgo
诞	dvo;
兜	dou/
凛	lso/
岭	lfi;
嚣	xyia
溅	jvo;
笛	dku;
舱	cpu/
罕	hgo/
鸭	yqi;
债	v[u
噬	smi
钉	dru
钉	dcu
躬	goui
倚	yku/
缕	lja
咚	doi
撼	hve
蕊	rf;
侄	vku/
佑	y/u;
雁	yve;
隶	lma
践	jvi/
拱	gle
沐	mno
菊	jje
蜂	fri
裕	ynoa
兆	vbu
搅	jh/
尿	nb;
黯	rvi;
歹	dae
蓄	xne
朦	mfu;
嘀	dki;
怯	qx/
叨	dy/
纽	nla
聘	pz
腻	nm;
剥	boa
彪	byi
沸	fx/
氓	mfo;
卷	j]o
榜	b;/
榜	b];
榜	pc;
逻	lli;
壳	kd/
壳	qb;
储	cju
憋	beo
啤	pki
匠	j]e
悍	hvo;
昧	mxi
泊	blo
泊	poo
篷	pfu;
烫	t];
狡	jhu
轨	gfe
汹	xoo;
携	xde/
磊	lde
隙	xma
仑	lsu;
摧	cre
瞄	mhi
胧	llu/
趋	que
挠	nhe
煌	h;ou
擅	sve
卒	cno
卒	zjo;
饼	bf/
狭	xau
丸	wgu
惫	bxu;
瞅	cli;
卡	qa
犬	q;e/
砖	vpe;
矣	yka/
楞	lce
昔	xie/
裳	spi
裳	c;i/
骆	l/a;
雇	gno
阎	ygoi
骷	ku/
鸦	yqe;
妞	no
墅	sni;
焚	fs;
谱	pjo
属	vja
绘	hca
梳	sue/
肿	vl/
魁	kf
耽	dte;
擒	qse;
陡	dla
璋	vpe/
茂	mbe
蹄	tki
瞥	pe;
瞳	tli
髅	lli/
绣	x/a
硕	s/e/
肺	fxu
参	cw/
参	swa
参	sta
兹	zio
炒	cho;
邮	yli
弘	hla
嫉	jka/
届	jxa
嗡	wr;
把	b[e;
娱	yja/
喧	xpi
脂	viu;
膛	t;u;
沧	cpo
疚	j/o
盐	yge/
扁	bg/
扁	pto
搁	gee;
茅	mhe/
滔	tyo
坟	fs/
掐	qq;
瑜	yje;
邱	qo/
桐	tle/
茵	ywe
苹	pfei;
旷	k]i
翘	qb/
郝	hhe
蓦	m/e/
诈	v[o
沫	m/o/
菁	jre;
粹	cco
琢	vle
腊	l[u
钦	qw/
喻	yni;
宪	xvo;
锻	d]u
睹	dji;
郊	jyo
饥	jiu/
侃	kg;
粘	vt/
媛	y;a/
谊	ymoa;
恳	ks;
厮	sie/
锤	cfue
凳	dca;
淮	hao/
蔽	bme;
聂	nx;
贩	fvi
潭	tgo;
翩	pto;
呻	swi;
枉	w;e
拘	ju;
煮	vje
焉	yte
址	vkei
匕	bku;
渗	szo;
览	lgi;
敦	dw;
厦	s[e;
蕴	yze
冉	rgi
薪	xwe;
呃	rxi
峻	jzi
荐	jve
栽	zq;
嚎	hhi
汁	vio
傍	b]/
秃	tu;
磕	kee;
禀	bfo
珑	llee
坎	kg/
邵	sba
萌	mfe/
窄	vao;
阮	r;a
蹈	dhi
碑	bee
婶	ssa
煤	mdo
寓	ynoo
栈	vve
滞	vmo;
倘	t;u/
杭	h;e;
暇	xai
藏	z]/
狈	bxu/
峡	xai;
侣	lju
芦	lje
蔓	mve
蒸	vre;
禄	lno/
胀	v]u;
醋	cne
淌	t;o;
伞	sg/
姊	zk/
钩	goue
衍	ygu;
妾	qxo
嘎	gai
蜀	sji;
蝴	hji
萝	llei;
莽	m;e
弩	nja
祷	dho
稚	vmu/
圳	vze;
徽	hru
衙	yau
咸	xge
陋	l/a/
奢	se
罐	g]u;
霄	xye
毙	bme/
汝	rjo
敞	c;io
暮	mne/
嘘	xui;
灼	vlo
澜	lgoo
姗	sta;
倪	nku
挫	c/e
咪	mi
钧	jwu/
捣	dhe
燥	zb/
泳	yloo
眶	k]i;
乙	ykaa
澈	cxo
焕	h]o
酬	cle
筷	k[u
宵	xyo;
揪	jo/
缚	fna/
蚁	yki/
喇	lai
丞	cfa/
拎	lw
吓	hxi;
棠	t;i
咙	llia
梭	soe;
哧	ci/
棺	gpe
璇	x;e
瀚	hvo/
肝	gtu
敛	lgu;
剂	jmoe
疤	bqo
渔	yjo/
嗔	cwi
沮	jjo
廖	lb/
虏	lji;
皓	hbu
勋	xwi
恕	sna;
虐	n[i;
虞	yji;
综	zoa
瘾	yso;
驴	lja;
晒	s[i
卦	g[ei
迦	jqa
陀	tla
窥	kro
堕	d/a
哆	doi;
葡	pje
帖	td;
垫	dve;
屡	lja/
鹅	rdu;
蛛	vui
盲	m;o
碟	dde
狞	nfu
囚	qli
诊	vs/
揽	lgei/
裴	pdi
捞	ly
吏	lmei;
铮	vru
萄	the/
盏	vg/
霆	tfe;
喔	wo;
贷	d[ui
给	jkaa
勿	wnu
吭	kri
淘	tho;
辟	bmae
辟	pm;
蔑	mxe
淹	yto
麒	qkoe
喽	loi
栗	lmei/
绷	bra
惚	huo
桓	h;e/
坊	fp/
桩	vpei
嗽	s/i
履	ljae
璐	lne;
菩	pje;
巢	cha
畜	cno;
畜	xno
兀	wne;
樊	fge
锡	xiue;
棚	pfei/
仕	smui;
倏	suu;
芹	qse/
僻	pm/
絮	xna
杏	xce
浆	jpo;
浆	j]o;
啧	zdi/
瘫	tto;
磁	cke;
冈	gpi
逮	daa
逮	d[a
搓	coe;
赠	zci
胶	jyu;
脊	jko;
噩	rxe
绰	c/a
呕	rli
嚼	jhi
嚼	jai;
谐	xdo
舍	sxu
歼	jte
揣	cqe/
揣	caei
殖	vkeu
拧	nfe
伺	cmu;
伺	smui/
霖	lse/
驼	tla;
襄	xpo/
衔	xgu
惕	tm;
掷	vme;
卸	xxu
炽	cmo
敖	rhe
惭	cgo;
框	k]e
捆	ks/
眩	x]i
蝉	cgi
谜	mko
炫	x]o;
塘	t;e
阱	jfa;
膜	mlu
亨	hro;
奕	ymoe;
蚂	mai
蚂	m[i
猩	xru
滨	bwo;
沁	qz
跋	bai
藩	fte
舔	tgu;
捐	jpe
歧	qki;
隋	sfa;
蹭	cci
甄	vwe
蜡	l[i
嗤	cii
缸	gpu;
嬉	xia
哮	xyia;
熄	xio;
窍	qbo
俞	yju/
豁	haoo
豁	ho/
豁	h/o;
垒	lda
掘	jaei
琦	qkee
屎	ska/
乍	v[u;
孽	nx/
毯	tgu/
弧	hja
槐	hae
铠	kau
挟	xdei
襟	jwo;
梨	lku/
嗅	x/i
祁	qkoa;
纲	gpa;
渠	qjo
矢	sku;
捅	tlei
扛	k;/
朽	xle
忖	cso
匈	xou/
扒	bqe
扒	pae
雍	yoo/
莺	yre;
侮	wjui
闺	gro
霓	nke
斋	vqo
稽	jiue
夭	yyu;
沦	lsoo
揍	z/e;
瞟	phi
苟	gle;
琉	llee;
漪	yio
暑	sji/
窟	kuo
钓	dbu
鳞	lsu/
瓷	ckoe
萱	xpe/
株	vue
倭	wo/
鞘	qbe
沛	px/
噜	lu
绞	jha
颓	tfue
睿	rc/
噗	pu/
唔	wji;
幢	v]ia
喀	kqi
诅	zjo/
涕	tm/
拣	jge;
谣	yho
叽	jii
葱	coe/
拭	smeie
婢	bmau
铸	vnu;
绮	qka;
剿	jha;
胤	yzu
秩	vmue
畔	pvi;
粥	voa
奎	kf;
绸	cla;
茨	cke/
觉	jbo
熏	xwu
蹬	dci;
诏	vbo
岔	c[u
叭	bqi
咆	phi;
滥	lvo;
梧	wje/
垮	kae
澳	rbo
浙	vx
甸	dvu
绯	fea;
诛	vuo
鲍	bbu;
刁	dya
厥	jaeu
蚊	wsi;
鞠	ju/
歆	xwo;
拙	voe;
茗	mfei
眷	j]o/
戮	lna/
唬	hji;
骏	jza/
扳	btei
踹	c[i
漓	lko/
蝇	yfi
擂	lxei
涡	woo
沌	dz/
凸	tu/
蚩	cia
酿	n]
唾	t/i
琐	sle;
犀	xia;
澄	dco;
澄	cfo;
哉	zq/
猾	hau
煎	jto;
窒	vmo/
虾	xqi
蝠	fji;
钞	cyu
瓣	bvoe
唧	jii;
觑	qn;
哽	gfi
娥	rda
婿	xna;
讪	svo;
耕	gre
葫	hje/
暧	r[i
浇	jyo;
嗨	hqi
诵	s/oa
疫	ymoe/
兢	jre/
箫	xyu
颅	lji/
啼	tki;
绅	swa;
杉	ste;
嗜	smi;
券	q];
遁	dzu
炯	jlo
霎	s[e/
讥	jio
迭	ddu
彷	p;u
觅	mmu
娴	xga/
抿	mse
剔	ti/
稻	dbu;
敷	fu/
泻	xxo
怠	d[a;
龚	goe/
绒	rla
讳	hco;
勺	shu
函	hga
喳	cqi
颂	s/u;
搀	ct/
撩	ly;
擎	qfe
巍	wei
脯	fjua
脯	pju
镶	xpu;
寥	lho/
漾	y]o
缴	jha/
藉	jkei
藉	jxe;
弊	bmo;
逞	cfi;
膏	gy/
戳	coa
呛	q]/
凹	ry
叩	k/i
禽	qsu
懊	rbo;
懈	xxo;
蛟	jyi
亢	k]o
呸	pe/
芊	qte
慑	sxoo;
跺	d/i
跄	q]i
蚀	sku/
栖	qie;
蔚	wxe
铲	cgu
坪	pfeie
筝	vru;
顷	qfe;
腮	squ;
别	bxi/
踉	l]i
划	hae;
当	d]i
狰	vru/
踱	dli
嗖	soi;
苑	y]e
秉	bfu
猿	y;u;
堤	di/
佟	tlui
悯	mso
唠	lhi
唠	lbi
憨	ht
肘	vlu
拇	mje
僚	lhu
霹	pie
婕	jda
禹	yjui
啃	ksi
匀	ysu/
颤	vvo
晖	hri;
怅	c]o;
聋	lleu
拯	vf;
忿	fzu
韧	rze
邹	zou
梢	sye
肋	lxu;
窘	jlo;
嵌	qvi
婪	lgeiu
辖	xae;
浦	pjo;
炭	tv/
曦	xiia
簇	cnu
螺	llia;
酱	j]oe
屯	ts
悴	cco;
匡	kp/
冀	jmi
倔	jaui
橙	cfe;
陕	sga
筱	xh/
叱	cmi;
髓	sfi
淳	cso;
矜	jwa;
詹	vtu
菱	lfe/
芷	vkei;
惺	xro
浊	vlo;
囔	np
朔	s/ou
憔	qho
睫	jdi
睬	caia
鸽	geu;
臀	ts;
吨	dw/
笙	srue
戟	jkei;
沼	vh/
谍	ddo
昕	xwi;
蛊	gji
煜	ynou
祀	smoa;
罡	gpi;
伶	lfu;
荫	ywe;
荫	yze;
酥	suei
懦	n//
厄	rxe;
峨	rdi
轴	vle;
伽	jqu
雳	lmeo
卵	l;u
捶	cfe/
檐	ygei
棘	jkei/
嗣	smi/
钗	cqu
袜	w[;
妩	wja
炕	k]o;
偎	weu
窦	d/o;
蝎	xe/
溶	rlo
膨	pfu/
峙	vmi;
缉	jia/
徊	hau;
呗	bei
衅	xzu
砂	sqeu
舵	d/u
昼	v/a;
迸	bco
斟	vwe;
舆	yjui;
椒	jye
靓	l]e;
旬	xsu;
厘	lke;
窑	yho;
萎	wde/
涟	lgoo;
疙	geo
瘩	dqo
瘩	dao
梵	fve
靴	xqe
侥	jhu;
匿	nm/
挚	vme/
镯	vlu;
兑	dco/
尧	yhe;
徘	pau
芽	yae
狙	juu
闵	mso;
辫	bvoe;
瀑	pn;
更	gre;
嗷	rhi
庐	ljo;
芯	xwe/
禾	hdu;
澎	pfo/
邢	xfe/
绊	bva;
蜘	vii;
憎	zr/
靡	mko;
靡	mko/
褚	vjo;
湛	vvo;
蒲	pje/
嚓	cqi;
珂	kee/
崽	zai;
贬	bgi
惮	dvo/
婵	cga;
嗒	t[i
悸	jmoo;
晦	hci
涅	nxo
恬	tgo/
慷	kpo
穹	qlo
渣	vqo;
屉	tma
缭	lha/
绢	j]a
袱	fjoa
黝	yli;
袅	nhu
淇	qkoo
茄	jqe;
茄	qd;
寅	yso/
赦	sxe/
祟	sca
榻	t[e;
蛙	wqi
苇	wdei
嵩	soi/
茉	m/ei
咏	yli/
凿	zh/
粪	fzo
噪	zbi
菌	jwe/
蝙	bti
庶	sno/
邸	dku/
禧	xko/
攒	zg;
旱	hvi
虔	qgi;
榴	llei/
琛	cwe
漱	snoo
忑	tx;
匣	xae/
忐	tgi
谬	m/oa
蟒	m;i
棱	lfei
钝	dzu;
悚	slo/
廓	k/o/
惘	w;o;
漉	lnoo
蟹	xxu;
佬	lhu;
曳	yxi
赎	sjia
壤	r;e
忡	coo
倡	c]u
冶	ydo
竿	gtu;
蜷	q;i
癌	ra;
嘈	chi/
蚕	cge
剖	poo;
颁	btu
缀	c/a;
汀	tro
谕	ynoa;
牡	mju
斐	fdi
懵	mfo/
分	fzu;
斗	dlo
皙	xiei
缪	mba
缪	mla
蔷	q;ei
诫	jxo
恤	xno;
咄	doi/
馒	mgu;
矫	jhu/
矫	jhue
痞	pko
橘	jje;
氧	y;u/
贿	hci;
肮	rp
瑾	jse
烙	lbo
璧	bmae;
攘	r;e;
攥	z]e
肖	xbi/
汰	t[o
溺	nmo
铅	qtu;
咔	kai
芭	bqe;
戎	rlea
褐	hxo;
巩	gle/
吆	yyi
彰	vpo/
漩	x;oo
聆	lfei;
蒜	s]e;
棕	zoe
鹃	jpi
帜	vmi/
鄂	rxi;
搐	cne;
蔼	ra/
怦	pr;
穗	scue
亩	mjo
撰	v]ei
绎	yma/
牟	mla;
咨	zio;
奄	yte;
梓	zke
亲	qc;
绚	x]a
阀	fao
烘	hoo
炙	vmua
翎	lfu/
惋	wgo;
驯	xza;
栩	xj/
逾	yjuo
墟	xue
鬟	h;ei
茬	caei;
褪	tc;
鑫	xwu;
骸	hai;
峭	qbi
缅	mga;
灶	zbo
洽	q[o
祯	vwo
暄	xpi;
裔	ymoeu
韶	sho
缎	d]a
砚	yve/
锥	vrue
辙	vde
惦	dvoo
铛	cru;
枣	zhe
桦	h[ei
邃	sco;
橱	cje/
搔	sye;
腑	fjua;
解	xxu/
萤	yfe;
枢	suei;
遏	rxi/
募	mnei
憬	jfo
庵	rt;
叼	dyi
嫖	pha
苛	keei
锣	llue
蹑	nxi
拌	bve;
奠	dvou
秽	hcu
殴	ro/
喋	ddi;
糙	cyo
貂	dyu
揖	yie;
葵	kf/
榆	yje/
颐	yke/
皂	zbu
眈	dti
扼	rxe/
眺	tb/
孜	zia
簌	snu
玺	xku;
偌	r/u
蹿	cpi;
蓓	bxe
弛	cka/
庇	bmo/
檀	tgei
枭	xyu;
螂	l;i
趾	vki;
崭	vgi
妲	daa;
掂	dte/
醇	csei
掺	cte
驿	ymaa
槽	che
惬	qxo;
镰	lgu/
抡	lw;
憧	coo;
删	stu
鸳	ypu
酣	ht;
宦	h]o;
筐	kpu
琅	l;e
瞻	vti
飙	bye
湃	p[o
俨	ygu/
跷	qy/
栅	v[e;
栅	ste/
撅	jqe/
煽	sto;
呱	gui;
缰	jpa/
猝	cnu;
衮	gs;
肴	yhu
殆	d[e;
谴	qgo;
蔬	suei/
飒	s[o
说	sco/
婧	jca
阐	cgo/
荧	yfe/
侈	cku;
霏	fee
瘟	ww;
芜	wjei
俭	jgu
崎	qki/
亥	h[o;
俐	lmu;
屿	yji/
譬	pma
饺	jhua
垄	lleu;
畴	cli/
杠	g]e
鬓	bz/
讼	s/oa;
晏	yvi;
弈	ymoeu
鞍	rt/
瘸	qa;
钮	nlu
珏	jaee
钰	ynue
傀	kfu
噔	dri/
驭	ynaa
靶	baei
萦	yfei
韬	tye
恙	y]o;
懿	yme/
竺	vju
吝	lz;
羁	jii/
荀	xse
癫	dto
嘭	pr/
菇	gue;
恃	smoo
儡	ldu
瘪	beo;
瘪	bd/
踌	clia
呦	yoi;
榕	rlei
昵	nmi
躇	cji
烬	jzo;
啰	loi;
酌	vle/
丙	bfe
涎	xgo;
哒	dqi
冽	lxo;
砌	qme;
鸾	l;oe;
烨	yxo;
翟	vaa
翟	dka
辗	nge/
噎	ye;
驹	jua
噼	pii
咎	j/u
亵	xxo/
陨	ysa/
蠕	rji
冕	mgi/
雌	cki/
茸	rlei;
瑛	yre/
剃	tmo
掰	bqu
蹙	cne/
橡	x]e/
佯	y;ui
笃	dju;
崛	jai/
勘	kte
稼	j[u
桀	jdu
渝	yjoo
汐	xio/
锈	x/u
磅	b]e
壕	hhe;
娄	llo;
撮	coei
撮	zle
玑	jie/
祠	ckoa
娲	wqa
鹫	j/o;
黏	ngu
珀	p/e
睽	kfi
栓	spei
绫	lfa;
阑	lgoi
邑	ymi
瑕	xaee
磋	coeu
粟	snei/
薯	sje
沪	hno
讷	nxo;
岑	csi/
炜	wdo;
玮	wdee
娼	cpa
迂	yu
伎	jmui
鲸	jru
翡	fdi;
坝	b[e/
铐	kb;
洼	wqo
蹊	xiia;
寐	mxo
肾	szi
鸯	ypi
敝	bmou
涧	jvo/
崆	ko;
甭	bfe;
笠	lmu/
扈	hno;
哝	nli
芮	rce
卉	hce;
靳	jze/
诬	wuo;
札	vae
婊	bha
裘	qle;
扉	feo
疮	cpo;
巅	dti;
坞	wne/
膳	svu
鳄	rxu
捺	n[e/
悼	dbo/
茧	jge/
毋	wja;
曙	sjia;
馅	xvu
簸	blu/
簸	b/;
忒	te;
奇	jieu
叟	slu/
拴	spei;
嬷	mqa
稣	suu/
痹	bmoe
垣	y;ei/
蛤	gdi
蛤	hai/
谏	jvoa
羹	gro;
沥	lmo;
蛾	rdi;
瑚	hjee
熔	rlo;
惆	clo;
雏	cju;
饷	x;u
拗	rbe
拗	n/e
燎	lhou
熠	ymou;
薰	xwei
蕃	fge;
捋	lje;
籁	l[u;
髦	mhei
飓	jnu;
簿	blue
簿	bnu
迢	tha;
闸	vao/
狩	s/u/
鲨	sqo;
蜥	xiia/
惴	vcoo
胯	k[u;
侨	qhu;
劭	sba;
烹	pro
咣	gpi/
攸	you;
锄	cju/
硝	xye;
颔	hvu
鸥	roe
滕	tfua
寰	h;oo
紊	wso
蕉	jye;
稠	clue
蟆	mai;
垢	g/e/
楷	kae;
炊	cro
忻	xwo/
炳	bfo;
腆	tgua
褒	byo
酋	qlo;
赃	zp/
拈	nt
拈	ngei
抒	sueie
孰	sjo
袄	rho
褂	g[o
孺	rja
胭	ytu
赘	vce;
嫡	dka;
礁	jye/
啜	c/i
钳	qgu
晾	l]i;
茎	jrei
隧	sca;
窿	llo/
骋	cfaa
嫦	c;a
掳	lje/
槛	kge
莞	g;e
莞	wgei
瓢	phe
曜	ybi
锯	jnu/
猖	cpua
遐	xaa
蹋	t[i;
飕	sou;
渍	zm/
麾	hro/
猥	wdua
篝	goue;
殉	xze
枷	jqei
蜒	ygi;
皎	jhui
霁	jme;
诩	xjo
窖	jbo;
咫	vka;
檬	mfei;
乒	pru
奚	xiuo
淤	yu;
父	fjuo
溯	snoo;
凋	dyo
纺	f;a;
篱	lkue
泌	mmo
刨	bbu/
刨	phu
樵	qhe;
忏	cv/
盎	r];
戾	lmo/
阿	re
咀	jji
屹	ymi;
冲	c/o;
挎	k[e
羔	gyo
殃	ype
庚	gro/
淼	mhi;
淀	dvoo;
隘	r[a
绛	j]a;
缨	yra
璨	cve
跤	jyi;
锵	qpu;
摁	rze;
痊	q;o;
嫔	psa
臻	vwe/
泯	mso/
糜	mdo;
睦	mni
喵	my;
缥	pya
褥	rn;
魇	ygeu
汶	wz;
馋	cgu;
渎	djo
蜿	wt/
抠	ko/
诶	re;
墩	dwe
棣	dme;
沓	t[i/
喏	rdi/
诲	hco/
琶	pae;
缈	mha
缔	dma
酝	yze/
耷	dqe
弼	bmae/
柬	jgei
浏	lloo
拷	kh/
剁	d/u;
柿	smeiu
琵	pke
沂	yko/
捻	ngei;
帛	blui
柠	nfe;
饵	rku
撂	lbe
娓	wda;
乓	pp
轲	keea
髯	rge
娉	pra
尽	jsa
圭	gre/
璀	cfee
苔	tqe;
苔	tae
肪	f;u
吮	ssi
瞩	vji;
啄	vli
帷	wdi;
箍	guu
蟑	vpi
炖	dzo
梗	gfe;
捎	sye/
嗬	hei;
蘑	mle;
唏	xiiae
鹊	q[e
矶	jieu;
羌	qpo
骼	gdi;
筛	squ/
鲤	lkua
羲	xiou
祺	qkoa/
馈	kc/
伫	vnu/
羿	ymao
苞	bye;
犁	lkue;
啬	sxei
舷	xgu;
矗	cnei
癖	pko;
掣	cxu/
匾	bge
瀛	yfo;
谧	mmo;
珞	l/e
毓	ynue;
衲	n[o
恺	kao
纬	wda/
惰	d/o/
嘤	yri;
诣	ymoa/
谛	dmo/
藻	zhe;
啷	lp
佘	sdu;
黠	xai/
饲	smua/
虬	qli;
涤	dko
骡	lla;
钵	bou
邯	hge
笋	ssu
芥	jxe/
醺	xwei;
佼	jhui;
舜	szu
龌	w/i
簪	zt
痰	tgoe
论	lsoa
蹂	rli;
恻	cxo;
簧	h;u/
甥	srue;
腼	mgu/
单	cgou
单	svo/
驮	tla/
缤	bwa
潺	cgoo
獠	lhu/
筏	fau;
锭	dcu;
阙	qq/
阙	q[o;
粤	y[u;
瞌	kei
琏	lgee
龊	c/i;
椎	vre/
唆	soia
煦	xni
嵋	mdi
幡	fti
翌	ymao;
毡	vtu;
碳	tve
鸨	bhu/
闽	msoi
躏	lz/
蜓	tfi
咻	xoi
捍	hve;
睨	nmi;
鼾	ht/
桔	jje/
娆	rha
抉	jaei;
蜻	qri
徨	h;uu
嗲	dai
碾	ngeu
哐	kpi
粼	lsou
啐	cci;
谑	x[o
嚏	tmi
鳖	beo/
榨	v[e/
倜	tmu
稷	jmue
篡	c]u;
晤	wni
肇	vbo;
咂	zqi
帚	vla
瘤	lloe
瞠	cri;
嚅	rji;
怆	c]o/
撵	ngei/
裆	dp/
腺	xvu;
骁	xya
坷	kde
螃	p;i
冢	vlo/
锢	gnu
濒	bwo/
蝗	h;i;
烽	fro;
莘	swe;
辘	lne/
撬	qbe;
瓮	wc
亘	gz;
钊	vyu
篓	llue;
缇	tka
宸	cso/
胄	v/i;
鞑	dae;
羚	lfo;
绥	sfa/
笺	jtu
荤	hw/
迄	qmu
踞	jni;
桨	j;o;
慵	yooo
噤	jzi;
幌	h;i/
跚	sti
袒	tgoa
浣	h]o/
榄	lgeiu
痪	h]oe
荼	tje
阉	yto;
腋	yxu
骰	tli;
曝	pn/
涮	s]o
踵	vli;
炬	jno;
涣	h]oo
俟	smuia
皑	rau
瞑	mfi/
渲	x]o/
擞	sle/
赂	lni;
湮	yto/
麓	lnei
铿	kru
埔	pjei
峦	l;oe/
涓	jpo/
掬	jue
怏	y]o/
莓	mdei
萃	cce
呲	zii
蹒	pg/
鳌	rhe;
睐	l[i;
昱	yni/
和	hju;
和	h/u;
旌	jro;
摞	l/e;
吠	fxi
濮	pjo/
谙	rto
啕	thi
轶	ymea
搪	t;e;
陇	lla/
纨	wga;
膺	yro
皋	gyu
霭	rae
呓	ymi/
橄	gge;
纶	lsa
垛	d/ei
嗫	nxi;
盅	voi/
踝	haia
臧	zpe
淅	xioo
岌	jki
岱	d[ui;
璞	pjee
缄	jta/
秧	ypu;
翱	rhu
卤	ljie
逅	h/u/
靥	yxe;
磐	pgu
壑	hxi/
斓	lgoe;
翊	ymoeo
挛	l;oei
叁	sta/
佗	tlui;
阖	hdo;
怂	sluo
戬	jgei;
汲	jko/
垠	yse;
迥	jli
咛	nfi
邂	xxua
杞	qkei
痘	d/oe
臊	sbu
藕	rlei/
媲	pma;
湄	mdo/
癞	l[o;
辄	vde;
獒	rhe/
恪	kxo;
砾	lmeu;
痉	jcoe
蜕	tc/
椰	ye/
差	cio
仨	squi
纣	v/a/
馁	nd
蜈	wji/
镐	gh/
窈	yho/
秤	ccu
粱	l;oo
辐	fjea;
悖	bxo
涔	csoo
偕	xdu/
渭	wxo;
汴	bvoo
蜴	ymia
桅	wdei;
隅	yjai
卯	mhu
骜	rbe;
孚	fjuo;
禺	yjia
琥	hjee;
杵	cjei
掖	yee
畸	jiia
晔	yxi;
婀	re/
菡	hve/
噶	gai;
昙	tgi;
坍	tte;
俑	ylu;
滤	lnoo;
侏	vuu;
潦	lhoo
挲	soo
硫	lleu/
俸	fcu
蟠	pgi
弋	ymea;
梆	bp/
驸	fnaa
笈	jkue
忱	csoo;
恿	yla;
龟	jwua
胥	xua
垦	ksa
窕	tho/
滇	dto;
珅	swe/
圃	pji
咿	yii
徙	xku/
瘴	v]o/
舫	f;u;
嗝	gdi/
泞	nc;
藐	mhei;
赣	gv;
鹦	yri/
逵	kfe
戍	sneu
榭	xxe;
揩	kqe
熹	xiei;
蟾	cgi;
霾	maeo
蔫	nt;
跛	bli
岐	qkia
脐	qku/
糗	qlo/
螳	t;i;
哺	bji
鹭	lni/
蚣	goi
嵬	wdi/
褶	vdo
恸	t/o
隽	j]u;
玥	y[e;
籽	zko
釜	fjuo/
剐	gai/
鸠	jou
磷	lseu
娑	soo;
巳	sma
谄	cgoa
恣	zmo
猬	wxu;
酪	lbe;
丕	pie;
溟	mfoo
隼	ssu;
芋	yne/
觊	jmi;
筵	ygue
娣	dma;
盹	ds
涸	hdo/
劾	hdoe
颌	hdu/
殇	speu
轧	y[e/
沽	guo
愫	snoo/
鸢	ype;
玷	dve/
掸	dge
溥	pjoo
疵	cio;
皖	wgu;
杳	yhe/
镀	dnu
祎	yio;
鹉	wjee
匍	pju;
崴	wa/
岖	qui
幔	mvi;
蝈	goi;
镑	b]u
臆	ymua
偃	ygui
蜗	woi
瞰	kv;
侬	nlu;
郸	dto/
缆	lga
袂	mxo;
诠	q;o/
犊	dju/
摹	mle/
蟀	s[i;
邋	lqa
竣	jzo/
骥	jmaa;
泗	smoo;
痣	vmoe
贲	bwe
胴	d/u/
潼	tlo;
弑	smuo
匐	fjua/
姣	jya;
谤	b]o
蘸	vve;
蟋	xiiae
渥	w/o
浒	hjo;
蛐	qui;
阂	hdoi
糯	n/o
愠	yzo;
嵇	jiue;
谒	yxo/
舀	yhu;
否	pke;
呤	lfi/
槟	bwe;
嘣	bri
脓	nlu/
樟	vpei;
忪	vooo
蛰	vde/
咤	v[i
阜	fnui
峥	vri;
濡	rjo;
遢	t[ia
担	dge;
瑙	nhe;
碉	dye
孵	fuu
讹	rdo
彝	ykaa;
颀	qkuu
篆	v]u/
臾	yjui/
椭	tlei;
沏	qio/
颦	psi
蛆	qui/
淆	xho
揄	yjei
压	y[eu
嗑	kxi
踮	dgi
犷	g;u
荔	lmeii
鳅	qou
闫	ygoi;
隗	wdai
渤	blo;
馍	mlu;
锏	jgu;
楣	mdei;
蜃	sze
遛	l/u
查	vqe
倌	gpu/
氤	ywu;
戌	xue;
嶙	lsi
馗	kfu;
匮	kce
揶	yde
胚	peu
啻	cmo;
敕	cme;
夙	snu;
珈	jqee
锹	qyu
摒	bce
迩	rku;
啾	joi
峪	ynia
菠	boe;
馥	fnue
槌	cfei
褛	ljo/
贻	ykia
礴	bleu
豚	ts/
氲	ywu/
湍	tp/
腌	ytu;
蚱	v[i;
殡	bze
毗	pki;
耙	pae/
诽	fdo
褴	lgoa
瘁	cco/
蚌	b]i
铝	lju;
蔻	k/e/
憩	qmu;
锚	mhu;
濑	l[o/
耘	yse/
俾	bku/
鬃	zoe;
裟	sqo/
苒	rge;
蘅	hfe
鱿	ylu/
傥	t;ui
袈	jqa;
豺	cau/
町	tfi;
掇	doe
坯	pie/
戛	jaeu;
贮	vni
塾	sjo;
剽	pye
孬	ny
衩	cao
镣	lbu
戊	wneu
犟	j]a/
酉	yle;
斡	w/e
匝	zqe
诘	jdo/
攫	jaei/
潢	h;oo;
黔	qgi/
臃	you/
罂	yria
轼	smea
酗	xne;
嘹	lhi;
阪	bga
冗	rlo/
桧	gce/
皿	msi
囡	nt/
辍	c/e;
觎	yjuo;
浚	jzoo
闰	rzo
臼	j/u;
蹩	bdo
煲	byu;
怵	cno/
囤	tsi
罔	w;i
蚓	ysi;
碴	caeu
灸	jlu
蚯	qoi
嗥	hhi;
堑	qve;
箴	vwu;
谗	cgoa;
嵘	rli/
箩	llue/
碱	jgeu
葆	bhe;
旎	nko
谆	vwo;
粽	z/o;
牒	ddu;
泸	ljoo
刽	gcu
诋	dko;
缜	vsa
爻	yhu/
贰	rm/
坳	rbe/
睑	jgi
葭	jqei;
妪	ynau
镂	l/u;
癸	gfa
笆	bqu;
壬	rs/
绉	v/aa
抨	pre
叵	pl;
箕	jiue/
坨	tlei/
颉	jdei/
姹	c[a
赳	joe
焊	hvou
淬	ccoo
纭	ysaa
埠	bne
泱	ypo
恹	ytoo
榛	vwei
酵	jbe/
銮	l;oei
佶	jkui
犒	kb/
茱	vue;
饪	rzu
孪	l;oei
砺	lmeu/
遽	jni/
嗟	jei
钙	g[u
谚	yvoa
鲲	kw/
谟	mloa
馊	sou/
雉	vmue;
虱	siau
糠	kpo;
赈	vzi
旮	gqu;
骠	bya
峋	xsi
跆	tai
瘠	jkoe
饕	tyi
佚	ymui
淄	zio/
谀	yjoa
镳	byu/
读	d/oa
廿	nv/
喟	kci
偻	llui
绺	llaa
骨	gui/
沱	tlo/
囱	cou;
兖	ygoe
袤	mbo;
畿	jiaa
诌	vooa
苯	bs;
佻	tyu
魈	xyu/
屌	dha
谲	jao;
泾	jro/
獗	jaua
蹶	jaia
绔	kna
雹	bhe/
旯	lai;
洱	rko
馄	hsu
粲	cvi
哂	ssi;
蔗	vx;
饨	tsu
奘	z]a
芍	she
淞	soo/
腴	yjua
剜	wto
汾	fso
顼	xue/
濂	lgoo/
蜚	fdi/
殒	yseu
鹞	ybu;
蚤	zha
浃	jqo
坂	bge;
颚	rxia
忤	wjo
眦	zmi
彗	hce/
暹	xti
赧	ngeie
佝	goui;
钺	y[u/
嘞	le;
硅	greu
玳	d[e/
蛹	ylia
睾	gyu;
盂	yjee
赁	lzu
瑁	mbe;
骛	wna
宕	d]o
纂	z;
堰	yvei
厩	j/e
萋	qie/
帔	pxi
杈	c[e;
熨	yza;
挞	t[e/
觐	jzei
煊	xpou
钏	c]u/
泫	x]oo
迳	jca;
缮	sva
燧	scou
孱	cga/
懑	mz;
柩	j/e;
漕	cho/
鹄	hju/
龛	ktu
饯	jvua
餮	tx/
幄	w/i;
鹘	gji;
倨	jnui
诙	hroa
锃	zcu
颧	q;ei;
纰	pia
鏖	rho;
氢	qru/
楔	xee
藜	lke/
栀	viei
谥	smoa/
骧	xpa
犄	jiuei
葳	wee;
魑	ciu
聒	goei
椿	cwe;
伢	yau;
谩	mgo
鹜	wna;
燕	yte/
闩	spo
颍	yfu;
濠	hho;
仞	rzu;
鳗	mgua
踊	ylia;
痿	wdo/
皈	gru;
骊	lka
孑	jda;
帼	gli
撸	lu;
檄	xke;
啵	boi;
柚	y/e
篑	kcu
陲	cfai
潋	lvo/
樽	zw/
遨	rhee
舶	bluu
莆	pjei;
蛀	vni;
抻	cwe/
搽	caei/
俪	lmui
铉	x]u;
嚯	h/i
茁	vlei
韭	jli;
膘	byua
酩	mfei/
榔	l;e;
娩	mga/
汗	hvoo
刎	wsu
扪	mse;
漳	vpoo
仃	dru;
饬	cmu/
壹	yie/
裨	bmoa
裨	pko/
巽	xza/
黜	cni
滂	pp;
鹂	lkei
徉	y;uu
戕	qpa
埂	gfe/
纫	rza;
溉	g[o;
胛	jaua;
锌	xwu/
遑	h;ui
跻	jiia;
蒿	hy
钛	t[u
岷	msi;
葩	pqe
磺	h;eu
汕	svoo
肛	gpua
涿	vooo;
鲛	jyu/
睥	bmi
滦	l;oo;
稔	rsu
锲	qxu
徜	c;uu
冼	xgo/
獐	vpu
喙	hci/
讧	h/o/
氨	rtu
褓	bho
赊	se;
菀	wgei;
鄱	pl/
炅	gci
碜	cseu
戗	qpu/
瓴	lfuo
酊	dfe
钠	n[u
镌	jpu
铀	ylue
羯	jdou
挝	woe
襁	q;oa
渚	vjo/
胫	jcu/
雎	jui
砥	dke
衢	qju
狒	fxu;
骞	qto;
荟	hcei
华	hau/
号	hbi;
正	vrei
石	dveu
汛	xzo;
色	sau
盥	g]u/
睚	yai/
栎	lmeiu
砣	tleu
烩	hcou
夯	hpe
拮	jdeie
驷	sma;
殓	lve
哔	bmi;
徇	xzu;
蹴	cni;
忾	k[o
疹	vso
鸵	tlua;
韫	yzee
祛	quo
膻	stu;
黢	quia
仄	zx
唳	lmi
烊	y;ou;
烊	y]ou
孀	spa;
腚	dcu/
牍	djui
佃	dvu;
赡	svi
秣	m/u;
榷	q[e;
镭	ldu;
铄	s/ue
嫒	r[a;
饽	bou;
谌	csoa
啮	nxi/
蝼	llia/
闱	wdoi
篙	gyu/
逡	qwa
膑	bzu
隍	h;a;
罄	qc/
蕨	jaeii
呢	nki
囵	lsi;
橹	ljei
睢	sri
喱	lki
肓	hpo
榈	ljei;
绶	s/a
槊	s/ou;
罹	lki;
槁	ghe
秸	jeu
裱	bho;
牦	mhu/
滓	zko;
腓	fdu
砝	fae
舐	smue
谶	czo;
秆	ggu
荏	rse
斛	hjua
暨	jmae;
滟	yvoo
纾	sua;
粑	bqo;
诳	k;o
寮	lhoo;
鹑	csoe
驽	nja;
囫	hji/
徕	lau
弭	mka
橇	qye
痢	lmoe
圜	h;ia
撺	cpe;
柑	gte;
儆	jfu
魉	l;u;
妊	rza/
氏	viu/
酶	mdei/
庖	pho
缢	ymaa;
俎	zju
鲫	jmua
藓	xge;
佰	bau
痔	vmoe;
觥	goua
哞	mo;
伉	k]u
怄	r/o
轱	gue/
泵	bce;
擀	gge/
蝌	kei;
绌	cna
蓑	soe/
釉	y/u/
翳	ymea/
讫	qmo/
蜇	ve;
蜇	vdei
砧	vweu
殄	tgeu
萼	rxei
胰	ykua
蜍	cji;
瘀	yu/
鸪	guei
霰	xve;
鹧	vx/
诨	hz/
僭	jvui;
弁	bva/
湎	mgo;
栉	jdeiu
蹉	coi
醍	tke
磬	qce
泷	lloo;
蓼	lhe
铂	blue;
梏	gne
鸩	vzo
豌	wte
嘬	zoi
疡	y;oe;
荞	qhe/
涝	lbo;
蛔	hfi
焖	mz/
祉	vko
魍	w;u
跎	tli/
锉	c/u
桎	vmei
喆	vdei;
娠	swa/
诿	wdoa
瓯	roe;
殚	dteu
镁	mdu
痂	jqo;
胱	gpua;
刍	cjua
醐	hjei
糅	rlou
愎	bmoo
赝	yveu
唁	yvi/
笳	jqu;
崂	lhi/
踽	jji;
鳍	qkua
帧	vwi;
骈	pga
仟	qtu/
羸	ldo
谪	vdo;
狲	swu;
槃	pgu;
珲	hre
蛭	vmia
痍	ykoe
猢	hjua;
鼹	ygui;
悌	tmo;
莅	lmeii
咩	me;
誊	tfou
鳝	svu;
韪	wdia
噱	jaia;
俚	lkui
硌	gx;
脍	k[u/
汞	glei
淖	nb/
姘	pw/
聩	kce;
泅	qloo
喑	ywi;
绦	dka/
铡	vau;
恽	yzo/
遒	qlou
痨	lhoe
蚪	dli;
蒺	jkeii
觞	spu
葺	qme/
煅	d]o;
悱	fdo;
茕	qle/
靛	dvee
诓	kpo/
箔	blue/
珥	rke;
岬	jaia/
臬	nxu
肱	goua;
焙	bxo;
鸷	vmei;
蜢	mfia
莠	yle/
铨	q;u;
胺	rvu
堇	jse;
嶂	v]ia;
钾	jaue
跹	xti;
鹌	rte
笞	ciu;
缛	rn/
椽	c;e/
苕	thei
酮	tleia
婺	wna/
貉	hduo
囿	y/i
铣	xkue
舂	coee
碘	dge/
馔	v]ua
铢	vuu/
涪	fjoo
氯	lnu;
傣	dau
度	dlo;
篾	mxu;
猕	mku
砒	pieu
颛	vpi;
柒	qioo
饴	ykua;
圩	wdei/
疱	pbo;
圄	yjia;
枸	glei;
貅	xouo
蛎	lmi;
唢	sli
窠	keo
囹	lfia
撷	xdei;
伥	cpui
疟	n[o;
傩	nlui
诟	g/o
嗞	zii;
赅	gqi;
楂	vqe;
氮	dvu/
竽	yjue
碣	jdeu
谔	rxo;
铧	haue
铆	mhue
滁	cjo
遴	lsou;
舛	c;ua
荠	jme/
稞	keu
阄	joo
荚	jaeii
媪	rha;
悒	ymoo;
笏	hnu
晷	gfi;
宥	y/o;
豸	vmuo
摈	bze;
凫	fjuao
阡	qta
粕	p/o
癣	x;oe
珐	f[;
馏	llua
龈	ysi/
锒	l;u/
虻	mfia;
腩	ngu;
吖	rqi
瓤	r;o
楫	jkeiu
镊	nxu;
阆	l]o/
豕	skeu
擘	b//
玎	dre;
馐	xoua
潍	wdoo
龅	byi;
黩	dji/
芪	qkei;
砭	bteu
腱	jvua;
挈	qxe
怼	dca/
嬗	sva;
貔	pku;
杷	paei
讴	roo
铬	gx/
沆	h]oo;
蝮	fni/
烷	wgo/
箜	kou
揿	qz;
茴	hfe;
鲈	lju/
昴	mhi/
缟	gha
瘙	sbo
痫	xgoe
矾	fge/
氖	nau
烯	xiou;
铰	jhue;
妯	vla;
耄	mbe/
搦	n/e;
飨	x;a;
鳏	gpua/
痼	gno;
讣	fno;
馕	n;u
鲇	ngu/
妁	s/a;
垩	rxei;
枇	pke/
幂	mmo/
蟊	mha;
萁	qkei/
鹳	g]e;
盱	xui/
帑	t;a
侪	caui
娌	lka;
煸	bto
孳	ziou
蚋	rci
脔	l;oei
箬	r/u;
樯	q;ei/
趸	ds;
苣	jnei
萸	yjei;
謇	jgo;
妣	bka
啁	voia
氰	qfu
蒹	jte;
莴	woe;
夤	ysua
鹬	ynao
腭	rxu;
鲑	gru/
淦	gv/
鲠	gfu
蚝	hhi/
瀣	xxoo
骐	qka/
堀	kue
柞	z/e/
泔	gto
锰	mfu/
蟥	h;ia;
薅	hy;
嵯	clia;
蛳	sii;
篦	bmu;
荜	bmei
焯	cyo;
芡	qve/
螯	rhee;
眙	ykia;
肄	ymua;
荨	qge;
耋	dde;
俳	pau;
铱	yiu;
薮	slei
笄	jiueo
渑	mgo/
豉	ckei
疣	yloe
镍	nxu/
轳	ljea
熵	spo;
瘆	szo/
杼	vne/
诂	gjo
鲶	ngua
氟	fjue
洄	hfo/
孢	bya;
郴	cwei
詈	lmi/
鞣	rleii
蜉	fji/
耦	rlee
蛉	lfia;
箪	dtu
愆	qtuu
藿	h/ei
痱	fxo
纡	yua
葚	sze;
黧	lkue/
毖	bmea
髋	kpi;
坻	dke;
蜊	lki/
铙	nhu;
漯	t[o;
骟	sva/
捌	bqe/
椴	d]e;
墒	spei/
溘	kxo/
牖	ylui
蹚	tpi
阋	xmo
龋	qji
刈	ymuo
悭	qto/
蠲	jpou
瓠	hne;
圪	gee/
轾	vmea
麸	fue
锱	ziu
瞽	gje;
糍	ckou
蹼	pji;
鳕	xau;
偬	zlu;
榫	sse;
秭	zku
瘢	bto;
殍	phe;
碇	dce
碓	dce;
孓	jaa
痧	sqoe
痈	yooe
埚	goei;
壅	yooe;
怙	hno/
癔	ymoeu
潆	yfo/
檩	lsei
痤	clo/
嘚	dei
菽	sueii
茭	jyei
酰	xte;
菏	hde/
诹	zoo
粳	jrou
糌	zt;
舸	gdu
趵	bbi
枥	lmeiu
膈	gdu;
傧	bwu
鸬	ljie;
艿	nae
酚	fwe;
椟	dje;
氦	h[u
笸	plu
疸	dgo
醛	q;eia
篌	hlue
枳	vkei/
酯	vkeia
髫	thei;
缳	h;a/
孥	nja/
溧	lmoo
镬	h/ue
卺	jsa;
皴	cwa
鍪	mla/
坩	gte/
砻	lleua
郯	tgou
筚	bmu/
跬	kfi;
醚	mke
蚧	jxi
肽	t[u;
绀	gva
顸	hte
谵	vto
鲟	xsu/
屣	xka;
鹚	ckou;
焗	jjo;
疖	jeo
炝	q]o
啉	lsi/
硒	xieu
伛	yjuie
蛄	guia
燹	xge/
缫	sya
髀	bmi/
凇	sooe
鼙	pkei
悛	qpo;
轫	rze/
苷	gtei
羝	dio
蘖	nxe
蚍	pki/
桡	rhei
耨	n/e/
搴	qtoo
榧	fde
蚜	yaia
轭	rxea
皲	jwo/
胝	viua
蝣	ylia/
鲋	fnua;
硼	pfeu
葸	xke/
溏	t;o/
鲱	feu
溽	rno
滏	fjoo;
彖	t]/
耜	smee;
嫠	lkee
锂	lkuee
劬	qju;
颟	mt
曈	tlia
濞	bmoo;
郫	pku/
怍	z/o/
螨	mgia
阈	ynoi
肫	vwu/
蝰	kfi/
蝓	yjia/
暌	kfia
蒌	lleii
颞	nxe;
鲷	dyu;
囟	xzu/
溴	x/o
畚	bs/
癜	dvoe
辊	gs/
嘌	pyi
烃	tro;
柽	cre;
秕	bkue
豇	jpe;
蛞	k/i;
颃	h;oe
骶	dki/
鳔	bbua
髂	q[i;
瘘	l/o/
胗	vwua
髌	bzi
楦	x]ei
籼	xto
齁	hou
骒	kxa
堙	ywe/
袪	quo;
酞	t[ei
鲻	ziu;
氪	kxu
