q	去
w	我
z	在
t	他
y	有
s	是
r	人
d	的
f	也
g	个
h	还
j	就
k	可
l	了
x	想
c	从
p	着
b	不
m	没
v	这
n	你
yi	一
la	来
so	说
s]	上
db	到
d[	大
mw	们
db;	道
n[	那
me	么
dm	地
zk	子
x[	下
cu	出
sk	时
kv	看
yb	要
tq	她
vo	中
v/	中
rg	然
lk	里
wd	为
wx	为
g/	过
zm	自
hh	好
de	得
dd	得
hc	会
tt	天
xw	心
h/	后
yk	以
xh	小
do	都
hd	和
dc	对
nf	能
qk	起
vi	之
sl	手
rk	而
vi;	只
vk	只
sr	生
sk;	使
sw	身
tl	头
y]	样
sm	事
do;	多
jk	己
jq	家
mv	面
vi/	知
kq	开
rj	如
wj	无
xv	现
hs	很
dg	点
qg	前
fq	发
f[	发
jr	经
qf	情
ba	把
lh	老
xe	些
h[	话
yk;	已
y/	又
sr;	声
ym	意
yj	于
hf	回
xb	笑
sl;	所
dv	但
yg	眼
cf	成
fp	方
ng	年
jv	见
dp	当
nj	女
vw	真
l;	两
lm	力
qm	气
y/;	用
c;	长
v;	长
d/	动
jt	间
jv;	间
gl	国
zl	走
r]	让
bx	被
gd	给
vc	正
wz	问
da	打
mf	明
rk;	儿
fa	法
ca	才
jk;	几
h;	行
xf	行
st	三
dc;	定
ck	此
jz	进
z[	再
vl	种
jp	将
sk/	实
tl;	同
zc	最
bs	本
x]	向
fw	分
ske	十
xa	学
gy	高
dm;	第
gg	感
zs	怎
ss	神
tr	听
bt	边
z/	作
qk;	其
bq	吧
q[	却
kl	口
ja	觉
rq	啊
yw	因
ba;	白
cm	次
jw	军
z/;	做
w[	外
ms	门
gp	光
fr	风
vj	主
vn	住
gl;	果
yj;	与
q;	全
rm	二
h/;	候
go	公
xp	相
x];	相
mq	吗
df	等
bd	别
sx	色
ske;	死
vp	张
bn	部
t[	太
rm;	日
sh	少
sb	少
vv	战
lk;	理
vk;	直
cl	重
v/;	重
w;	王
x]/	像
lg	脸
bk	比
k[	快
hd;	何
sf	水
mf;	名
tk	体
ne	呢
do/	东
jb	叫
xi	西
yr	应
yc	应
bv	便
pg	便
f]	放
ma	马
ng;	难
qr	轻
gc	更
md	美
wx;	位
gp;	关
ji	机
je	接
xt	先
ws	文
cj	处
cn	处
bc	并
w]	望
c;;	常
wg	完
sm;	四
fe	飞
si	师
vd	者
rt	安
qr;	清
gp/	刚
gw	跟
y[	月
xz	信
st;	山
r[	爱
nx	内
ll	龙
ko	空
k/	空
d[;	带
vh	找
y;	原
rn	入
lk/	李
lg;	连
ci	吃
c;/	场
pf	平
si;	思
ls	林
bv;	变
ss;	什
yl	由
s/	受
qw	亲
mc	命
mn	目
q;;	强
ng/	男
rz	任
gq	该
ln	路
ce	车
jw;	今
ha	海
jq;	加
y;;	远
hl	活
tx	特
jd	解
dv;	电
sm/	世
xc	性
bh	表
xj	许
tq;	它
lm;	立
he	黑
jw/	金
hl;	红
hq	花
v;;	转
v]	转
zl;	总
s];	算
cf;	城
dc/	队
ha;	孩
fg	反
go;	工
ska	始
mg	满
xw;	新
br	兵
wn	物
lko	离
fe;	非
sr/	虽
ys	云
smu	似
wv	万
vm	至
gt	干
gv	干
to	通
rz;	认
si/	失
hl/	火
ge	哥
sme	士
wj;	五
jr;	惊
ml	魔
jc	竟
jd;	姐
hu	乎
jv/	剑
w;;	往
l;;	量
l]	量
zh	早
jd/	结
p[	怕
ll;	流
tu	突
z//	坐
sie	斯
yw;	音
js	紧
vk/	指
lq	拉
sq	杀
bv/	半
jm	记
qd	且
lm/	利
hd/	合
dh	倒
db/	倒
su	书
dn	度
we	微
bn;	步
jy	教
jb;	教
xk	喜
y[;	越
yf	影
sd	谁
lf	冷
sw;	深
gb	告
l/	落
x]u	象
rl	容
g[	怪
c;u	传
v];	传
qg;	钱
tk;	提
yg;	言
sf;	随
md;	每
sp	双
fj	服
ji;	击
wj/	武
na	哪
sj	数
sn	数
vv;	站
qk/	奇
f;	房
g;	管
lf;	灵
kx	刻
tk/	题
yi;	衣
vo;	周
jc;	静
sp;	伤
ba/	百
na;	拿
mq;	妈
bva	办
xr	星
h[;	化
go/	功
ja;	绝
xm	系
bt;	般
bm	必
yx	业
rk/	尔
jvu	件
xd	血
x[;	血
d[/	代
jr/	精
dm/	弟
vo/	终
jz;	近
th	条
qr/	青
jx	界
sia	司
vf	整
hp	欢
zm;	字
wg;	晚
ms;	民
bp	帮
qe	切
qx	切
jk/	即
m;	忙
jy;	交
h//	或
rv	暗
fu	夫
y;/	员
gw;	根
ske/	石
hq;	哈
yx;	夜
fn	父
vm;	制
yl;	友
rq;	阿
xi;	息
co	冲
jl	酒
bh;	保
pv	片
xf;	形
vz	阵
nge	南
ja/	决
qf;	请
gx	各
bb	报
xr;	兴
xc;	兴
y;a	阳
jku	急
yj/	语
lc	令
c/	错
jka	及
ll/	刘
jke	极
sko	识
bx;	备
mv;	慢
xa;	雪
kj	苦
r/	若
lf/	领
so;	收
dk	底
jz/	尽
vs	准
kt	看
ha/	华
h[/	华
da;	答
v//	众
qt	千
yy	要
xy	消
smo	视
lli	罗
gg;	敢
llu	留
kx;	克
lx	乐
y[/	乐
g/;	够
ph	跑
xg	显
zf	嘴
gpo	官
d]	断
wx/	未
sme;	势
jn	句
ql	求
jm;	计
lz	论
da/	达
zd	则
h[o	害
bq;	八
dt	单
jl;	久
jh	脚
dd;	德
y;e	元
nh	脑
cj;	楚
yje	雨
jri	睛
x;	响
dy	刀
q[;	确
yn	玉
dd/	得
cs	沉
bd;	北
gd;	格
tf	停
cs;	陈
smo;	市
vy	朝
ch	朝
he;	喝
zj	族
jp;	江
t;	团
mj	母
vp;	章
vp/	装
l];	亮
kx/	客
vb	照
l]/	乱
ym;	易
zj;	足
yi/	依
h;;	黄
xo	修
p/	破
ta	台
ql;	球
yq	呀
y];	院
s/;	送
by	包
ym/	义
sn;	诉
goe	攻
sia;	丝
wd;	围
wg/	玩
dq	待
d[u	待
fn;	复
k]	况
lle	楼
lme	丽
t/	痛
mc;	梦
hu;	呼
yh	摇
qke	期
yr;	英
di	低
dmo	帝
xo;	兄
be	背
bx/	背
ck;	持
yd	爷
h;/	皇
qi	七
l/;	六
cp	穿
du	都
y;e;	杨
vc;	政
yz	运
ju	居
yx/	叶
rx	热
jb/	校
xb;	校
xx	谢
cf/	曾
gj	古
xm;	细
cg	产
sc	睡
xi/	希
sn/	速
smo/	室
p;	旁
lc;	另
hao	怀
ln;	露
yma	异
xd;	写
gf	鬼
n;	娘
qj	取
sme/	式
cj/	除
jka;	级
kh	考
jva	建
y]/	愿
vy;	招
fv	饭
bn/	布
xn	续
cfu	程
sl/	首
gpa	观
pf;	朋
wn;	务
dbe	掉
gg/	赶
hu/	忽
vn;	注
sne	术
sz	甚
cq	差
c[	差
he/	呵
vg	展
vr	争
ps	品
lg/	兰
bh/	宝
xp;	香
d/;	斗
gn	故
ld	雷
nv	念
d];	段
dz	顿
jh;	角
jau	角
yk/	疑
hn	护
sg	闪
mn;	木
xu	需
dbo	调
th;	调
lx;	类
mx	妹
b[	爸
xv;	线
zl/	左
yl/	游
p[;	派
tg	谈
ji/	激
br;	冰
dk;	敌
tb	跳
vie	支
yq;	约
bq/	巴
ns	您
gn;	顾
ks	肯
xf/	醒
td	铁
bb;	抱
dv/	淡
zb	造
hlu	伙
zi	资
qs	群
jku;	集
lge	联
sp/	商
hh;	号
hb	号
jde	节
j;	讲
v;/	掌
vb;	赵
mm	密
jl/	九
bc;	病
wxa	卫
mk	米
we;	威
jm/	继
jvo	渐
tl/	统
vr;	追
y[e	亚
jg	简
lv	练
jie	基
x;;	选
tr;	推
ga	改
tc	退
wxi	味
fz	份
jj	举
smee	示
rs	忍
lme;	历
qm;	器
kl;	恐
ys;	引
smoa	试
pk	皮
xk;	习
kb	靠
dh;	导
cs/	存
m/	莫
vm/	志
qu	区
hv	汉
y//	右
yg/	严
t[;	态
ma;	买
xc/	幸
sx;	社
fl	佛
fj;	佛
ymo	议
sne;	树
vki	止
k[;	块
slo	守
mh	毛
hr	挥
hj	胡
sg;	散
sv	散
bg	板
js;	仅
ys/	隐
nn	怒
c;o	床
su;	苏
lb	料
gj;	股
jj;	局
bt/	班
tj	图
sc;	岁
lko;	礼
dj	独
cu;	初
fj/	福
sz;	顺
k;	狂
m/;	默
jn;	巨
jma	既
so/	松
vc/	证
lx/	烈
fl;	否
rd	恶
rx;	恶
wn/	恶
vmo	治
h;a	缓
pa	排
fx	费
pq	拍
rke	耳
yie	医
hg	寒
ku	哭
ww	温
fjo	府
dt;	担
dve	担
cz	称
cr	称
cc	称
yju	余
vou	钟
lxo	泪
yt	烟
rf	仍
jn/	具
w];	忘
rw	恩
bm;	毕
jf	警
lge;	蓝
goo	宫
xii	吸
ln/	陆
jo	究
vq	抓
yq/	压
sq;	沙
j/	救
dq;	呆
hdo	河
mk;	迷
qp	枪
zj/	组
q;/	权
tv	叹
sw/	孙
j;;	卷
ca;	查
hh/	毫
cw	春
ca/	察
sc/	圣
ch;	草
jbe	较
scu	胜
yn;	遇
co;	充
ski	史
t;;	堂
f;;	防
jne	据
mf/	猛
qka	骑
tj;	土
ka	卡
vn/	助
jro	京
ysu	银
gc;	贵
ylo	永
vmu	质
wu	屋
xu;	须
fn/	副
h]	换
cm;	刺
sj;	属
ws;	闻
jc/	境
jwe	禁
jze	禁
yw/	阴
g//	共
fnu	负
n/	弄
ft	翻
hj;	虎
cfa	层
hg;	喊
th/	逃
xh;	晓
z/o	座
ya	雅
ct	参
sx/	射
hw	婚
xg;	险
jwa	君
h[e	划
jt;	坚
j[	价
rl;	柔
cy	超
y;e/	扬
ke	科
rv;	按
hs;	狠
yd;	野
qs;	秦
mm;	秘
slo;	熟
sj/	熟
vmi	置
xt;	仙
ml;	模
mj;	模
swu	伸
bo	波
r/;	肉
jau;	假
j[;	假
qko	齐
wju	舞
to;	脱
g;;	广
gu	姑
ma/	麻
tle	投
df;	顶
vme	致
zd;	责
jf;	景
yf;	营
wd/	维
sxo	设
h[e;	坏
lq;	啦
x/	秀
b[;	败
md/	眉
voo	州
yb;	药
cfa;	承
rv/	案
l;/	狼
vpe	专
to/	偷
h[e/	画
wji	吴
dvo	店
r//	哦
dva	弹
tg;	弹
sku	食
yn/	欲
ta;	抬
by;	标
qo	秋
lme/	厉
l;o	良
jma;	际
v]/	状
fg;	烦
wju;	午
bae	摆
xm/	戏
voi	桌
c;u;	船
d;	短
cw;	村
ml/	某
mo	摸
fnu;	付
ygo	演
gr	规
xy;	萧
fr;	封
w/	握
tg/	田
t;/	唐
c;e	藏
vz;	震
hs/	混
hz	混
xu/	虚
t/;	透
jma/	纪
lfo	凌
xo/	休
mq/	嘛
mde	梅
zk;	紫
ge;	歌
ls;	临
dj;	毒
zo	宗
vne	著
sle	索
yz;	印
xs	寻
hj/	湖
jza	劲
vke	职
jme	技
hz;	恨
pl	婆
jde;	杰
yja	羽
zg	咱
sne/	素
fg/	凡
vku	值
py	飘
y;o	养
hei	嘿
pj	普
nf;	宁
nc	宁
x[/	吓
s//	兽
x[e	夏
dj/	读
je;	街
nl	牛
f;/	仿
xou	胸
l]o	浪
fno	富
s]/	尚
yjo	宇
gj/	骨
vmu;	智
fw;	纷
sru	升
su/	叔
sv;	善
r/a	弱
j[/	架
m[	卖
d[u;	袋
w;/	网
vu	朱
m[;	骂
xl	雄
s[	赛
l[	略
be;	杯
sio	施
q;e	墙
h;e	环
zc;	罪
ya;	牙
cp;	窗
lle;	柳
tr/	厅
gh	搞
dp;	端
d//	洞
smu;	适
yo	拥
smu/	释
y;o;	洋
jt/	肩
hse	魂
nb	闹
mr	蒙
mfe	蒙
mfe;	蒙
xk/	洗
dr	灯
jx;	借
bl	伯
mg;	免
c[;	菜
yv	验
fc	凤
yju;	鱼
xj;	徐
xfe	型
n[;	娜
nl;	娜
bb/	暴
w;o	亡
tho	讨
bxi	辈
dl	懂
tf;	腿
mx;	灭
mb	妙
xb/	效
we/	危
yo;	优
pg;	盘
tb;	套
dr;	丁
qn	趣
yy;	妖
snei	束
za	杂
sio;	诗
yf/	迎
sd;	舍
j/;	旧
cau	彩
wdu	委
g[;	挂
bk;	笔
gl/	狗
xt/	鲜
xg/	鲜
vka	纸
k];	抗
tv;	探
hg/	韩
nk	尼
k/;	控
xko	惜
vu;	珠
co/	抽
cp/	创
c]	创
gr;	归
tf/	挺
fz;	奋
pd	陪
yc;	硬
bm/	避
y;i	园
toe	托
xz;	训
yla	勇
lh;	聊
v/u	种
na/	奶
vpo	庄
bw	奔
bz	奔
vz/	镇
q;o	拳
cau;	采
yge	研
j]	将
px	配
jx/	介
zw	尊
mb;	冒
lni	虑
jce	敬
dt/	丹
suu	舒
dva;	蛋
hr;	哼
s/o	宋
jmo	济
fna	妇
jvu;	箭
va	择
zd/	择
fv;	犯
xw/	欣
jai	甲
ro	欧
kxo	课
pu	扑
fe/	菲
fd	菲
yv;	燕
qu;	曲
qj;	曲
dl;	躲
x;/	玄
h];	幻
cae	茶
vd;	折
sd/	折
yiu	伊
sa	傻
xca	姓
y;o/	源
l//	洛
bvo	遍
cse	臣
qm/	弃
ylu	犹
vt	占
vv/	占
py;	漂
ph;	漂
pb	漂
ty	挑
the	挑
h/e	获
lna	绿
fr/	峰
jzu	俊
fro	疯
lxe	列
zo;	作
swe	森
qi;	妻
lv;	恋
wno	误
b[/	拜
wdu;	伟
yku	移
n[/	纳
d;;	党
b[i	罢
yy/	腰
qh	巧
gu;	孤
bmo	闭
y;i;	圆
pc	碰
jcu	镜
r;	软
h/e;	厚
ld;	累
lxi	累
zli	昨
yo/	幽
be/	悲
v]e	丈
pa;	牌
j];	降
x;a	降
ygo;	颜
lh/	劳
pt	偏
sf/	省
xfi	省
hjo	糊
hn;	糊
g;/	馆
sy	烧
wxo	谓
cai	财
jvu/	舰
hgo	汗
hv;	汗
n[e	奈
cy;	操
jmo;	迹
sia/	尸
qh;	悄
cg;	残
jti	尖
lj	鲁
fru	锋
j]/	圈
qp;	圈
ylo;	油
la;	俩
x]e	项
v]e;	撞
sz/	瞬
ymo;	忆
g[/	盖
yle	尤
tj/	徒
xp/	乡
g[e	概
hn/	户
d]/	荡
yme	艺
zr	增
zjo	祖
kz	困
dva/	殿
xz/	迅
hf;	横
hc;	横
fv/	范
lnu	律
ft;	番
qku	企
cg/	惨
xv/	限
jne;	聚
hgu	含
pf/	凭
jna	剧
sce	碎
t;u	躺
y;a;	缘
l;o;	凉
tfu	腾
via	织
qp/	抢
q;e;	抢
yna	预
ss/	沈
tm	替
kl/	孔
pi	批
kp	康
h/e/	惑
wdi	唯
lno	率
g]	惯
dr/	登
hne	互
dri	盯
sy;	稍
xpo	宣
c];	唱
cfo	诚
scu;	剩
yh;	咬
yno	育
vu/	诸
cn;	触
csi	晨
cx	策
tfo	疼
mv/	漫
cae;	材
bj	补
siu	私
tji	吐
tn	吐
csa	纯
r[;	艾
bxi;	贝
gju	谷
tfo;	庭
d;/	挡
h;i	晃
h]/	晃
jke;	吉
cr;	吹
za;	仔
cl;	仇
nf/	凝
gje	鼓
nl/	农
xko;	席
vr/	征
s[;	帅
fna;	附
qq	缺
sq/	塞
s[/	塞
sxo;	塞
hho	豪
ymo/	亦
dn;	杜
nj;	努
pv;	判
mlo	谋
dg;	胆
csi;	尘
vq;	扎
gs	滚
mw;	闷
mz	闷
ck/	迟
ws/	稳
yma;	翼
n/;	诺
xgo	闲
hr/	灰
dl/	朵
cfe	盛
sce;	盛
l;o/	梁
jri;	晶
ct;	餐
hb;	好
bbo	爆
ls/	伦
jy/	娇
cx;	侧
lc/	愣
bk/	鼻
lse	轮
hw;	昏
dle	抖
xva	陷
ms/	敏
cko	词
hp;	慌
fz/	愤
lgo	怜
cv	颤
je/	阶
cpe	苍
jni	距
vco	郑
cpu	川
sh;	扫
sb;	扫
bi	逼
xvi	县
yoo	忧
tlo	童
vke;	执
dou	丢
rl/	荣
bma	臂
vj;	逐
rb	傲
d[e	戴
m;;	芒
qc	庆
bvu	伴
xke	袭
gou	供
g/u	供
jiu	积
cx/	测
yh/	遥
zja	阻
lmu	例
vri	睁
dh/	岛
yki	遗
dci	瞪
mn/	慕
v/u;	皱
bl;	博
mne	幕
cq;	猜
ymou	益
jco	净
zdo	泽
lv/	炼
jti;	监
jia	鸡
vw;	珍
fju	伏
sb/	绍
ch/	曹
pa/	爬
yqo	丫
va;	炸
v[	炸
bma;	壁
ylo/	涌
xou;	凶
l;oa	郎
sno	宿
xl;	宿
x/;	宿
y]u	怨
zc/	醉
pw	拼
p/;	迫
gd/	革
qh/	瞧
rb;	奥
sue	输
lmei	莉
voi;	忠
ke;	颗
rw;	嗯
jq/	佳
lj;	旅
rs;	仁
nh;	鸟
pv/	骗
hb/	浩
ta/	塔
p]	胖
xn;	绪
fre	枫
bae;	拔
zv	赞
pb;	炮
fnu/	傅
ka;	凯
xd/	邪
fp;	芳
hso	浑
dle;	夺
kp;	宽
dre	堆
lxe;	裂
zy	遭
cm/	赤
x;o	旋
x]o	旋
nle	扭
jdo	洁
fjo;	浮
xiu	悉
nv;	难
cq/	擦
hc/	慧
dg/	典
s;	赏
cou	匆
pfo	评
z/a	纵
lge/	莲
wne	雾
wu;	乌
y[i	跃
v]o	壮
te	贴
fre;	丰
gda	隔
jvui	健
xwo	辛
dk/	抵
vj/	竹
cxu	彻
mlo;	摩
ho	轰
bta	编
dju	肚
dn/	肚
cqe	插
mlo/	磨
m//	磨
rq/	哎
ynu	御
n[e;	耐
jno	惧
smua	氏
hri	辉
fje	扶
hro	恢
mb/	貌
rd;	额
snei;	述
pb/	票
lna;	录
toe;	拖
b;	膀
p;;	膀
yr/	鹰
mc/	孟
dmo;	递
rc	瑞
cse;	唇
zv;	暂
h/u	货
qs/	琴
zo/	踪
mae	码
wxa;	慰
sdi	蛇
lfe	玲
ywi	晕
yz/	晕
sse	损
xpe	轩
cu/	粗
yge;	掩
pm	屁
you	悠
y;u	仰
lfe;	零
mfi	盟
tju	途
zdi	贼
hlo	洪
wno;	悟
gn/	固
y[o	讶
dou;	冬
hao;	滑
tgu	甜
yne	郁
lse;	琳
l]e	辆
naa	乃
vuu	猪
n;;	暖
ni	妮
vre	挣
vce	挣
dvi	旦
gu/	估
tge	坦
gt;	甘
px;	佩
la/	莱
x;o;	享
hli	吼
g/e	构
fs	粉
s[e	萨
wsi	吻
qg/	潜
pfo;	瓶
rlu	偶
jxe	戒
nlo	浓
hf/	毁
xy/	销
dki	迪
jne/	拒
rb/	绕
lxe/	勒
le	勒
l;oa;	朗
xii;	嘻
wda	尾
yka	尾
v]i	帐
fx;	废
ygu	延
qy	敲
lvo	烂
mvi	曼
yv/	厌
yko	宜
xoo	羞
wxi;	喂
ysi	吟
di;	滴
voo;	洲
de;	爹
yve	艳
qf/	晴
fje;	抚
soa	缩
xde	协
yp	央
hfo	悔
xyi	肖
xbi	肖
cga	缠
cc;	脆
hso;	痕
wju/	伍
jmo/	寂
qko;	启
x;o/	翔
bhe	薄
bl/	薄
b/	薄
hlu;	侯
q]	劝
goo;	郭
nj/	奴
mfi;	鸣
qru	倾
bku	彼
rr	扔
sqe	撒
sa;	撒
yna;	豫
jg;	检
vw/	针
yb/	耀
ci;	痴
mj/	姆
pt;	篇
yke	椅
c;e;	厂
dle/	董
xl/	熊
mae;	埋
gq;	乖
hju	狐
j;/	蒋
t[/	踏
lla	隆
k//	括
cho	潮
r[/	唉
ql/	穷
coe	聪
h]i	唤
t[e	泰
bg;	版
m/e	末
qko/	旗
yku;	仪
jyu	焦
my	猫
dbo;	盗
smui	侍
jke/	挤
k;;	款
skei	拾
hp/	荒
q;a	强
zi;	姿
yne;	域
dq/	搭
m[/	脉
m/u	脉
s/e	授
sju	俗
rle	融
ynu;	狱
qi/	欺
f;o	访
qhe	桥
slu	锁
b[e	霸
qt;	牵
cko;	池
zp	钻
z]	钻
g;o	港
ngi	喃
tfu;	廷
cfu;	乘
mae/	玛
fc;	奉
cd	扯
y[u	岳
jg/	减
wt	弯
jae	夹
cku	辞
rvi	岸
qki	岂
qu/	屈
nh/	恼
vd/	哲
jmu	季
vb/	召
spe	丧
s]e	丧
c;i	尝
goe;	恭
za/	载
z[;	载
s/o;	瘦
jee	皆
po	颇
m;/	茫
rg;	染
sna	肃
s;;	爽
kr	亏
tw	吞
rd/	惹
rqo	哀
qhu	乔
cz;	趁
pu;	铺
pn	铺
zp;	脏
lj/	吕
j;o	奖
bxu	倍
tp	汤
vze	振
tfa	婷
lho	牢
rh	扰
lo	溜
l/o	溜
p;/	庞
c/;	臭
y[o;	悦
hx	赫
yfo	赢
gc/	跪
m[e	麦
vie;	枝
xa/	侠
q;u	泉
jde/	劫
ygo/	炎
nk;	泥
dji	赌
goa	弓
wxu	魏
vbi	罩
jko	疾
smua;	饰
fju;	符
cfu/	垂
yc/	映
m/o	漠
blu	脖
ysu;	饮
ygoo	沿
lgo;	懒
fu;	肤
spa	桑
kt;	堪
rg/	燃
vl;	卓
vno	祝
l[;	赖
bw;	宾
jae;	贾
c;i;	喘
yvo	焰
chi	吵
mfo	冥
xde;	鞋
ymu	逸
jwe;	均
kn	库
kn;	裤
wge	碗
h;u	航
ti	踢
yka;	姨
spe;	酸
xbi;	啸
lfi	龄
gdo	阁
sdu	舌
xpu	箱
ff	冯
bp;	邦
gpu	钢
xae	霞
cn/	促
pbo	泡
dz;	盾
y;ou	羊
bme	碧
y;ei	援
jmae	忌
jea	结
mle	抹
m/e;	抹
qv	倩
rc;	锐
pw;	喷
lgei	拦
jqe	嘉
x//	袖
sue;	殊
cse/	辰
fgu	繁
l/a	络
py/	抛
j[a	嫁
v/i	咒
cxe	撤
jvue	键
sio/	湿
q[/	恰
cl/	虫
sso	审
xve	献
mx/	媚
xgi	贤
gde	葛
squ	刹
c[/	刹
y;ei;	袁
sqe;	摔
xn/	序
vnu	筑
xdu	斜
wa	瓦
tjo	涂
wt;	湾
sqe/	莎
cli	崇
lxu	猎
xfe;	刑
m/i	墨
wa;	娃
ti;	梯
the;	桃
d/e	豆
j[a;	驾
qgo	浅
jcu;	径
rx/	饿
pk;	疲
bte	搬
gq/	瓜
yfe	莹
zi/	滋
rz/	润
lfu	铃
mg/	蛮
dme	蒂
bo;	拨
ty;	涛
yja;	予
gou;	勾
hce	惠
xie	析
l[/	落
lb;	落
kg	砍
cr/	撑
jdei	截
c//	措
bmu	币
wee	薇
ynu/	愈
du;	督
kn/	酷
x;oa	祥
bno	怖
qw;	侵
ygi	岩
bve	扮
zy;	糟
yfa	盈
fnua	腹
vg;	斩
cka	尺
qt/	签
xiu;	稀
ty/	掏
kq;	夸
qmo	汽
yxo	液
jia;	姬
kc	愧
hco	汇
vne;	柱
l;ou	粮
bhu	堡
v]u	仗
bz;	笨
z/e	奏
qv;	歉
sa/	甩
vco;	怔
ysa	允
jco;	竞
h/o	祸
ye	耶
yd/	耶
jau/	爵
jmaa	绩
y/o	诱
wu/	呜
xao	穴
lku	黎
zu	租
pd;	培
zae	砸
jf/	井
wo	窝
mk/	弥
fgu;	返
pk/	匹
sai	啥
c/o	凑
jta	奸
m/a	陌
pvo	叛
hde	核
hje	核
w/;	卧
fji	幅
va/	眨
hbe	耗
sao	洒
yko;	怡
x;oa;	详
lji	卢
k/e	扣
wq	哇
cla	丑
mgu	勉
xbe	孝
mh;	矛
fw/	氛
hfu	衡
tha	陶
g/i	购
wp	汪
jp/	僵
lho;	疗
fea	妃
fa;	罚
jmu;	系
qke;	棋
ff;	缝
fc/	缝
fni	咐
quu	躯
fvo	泛
clu	愁
x[u	血
soe	搜
cko/	慈
fd;	肥
llu;	笼
lgu	篮
jnu	俱
wdo	惟
gce	柜
voe	捉
x;i	悬
h/eo	霍
xx;	泄
yt;	咽
yvi	咽
cki	齿
mh/	秒
qse	勤
k/e;	扩
bf	屏
pfa	屏
spe/	霜
ph/	袍
ddi	蝶
jmu/	祭
fje/	夫
cje	厨
xdu;	胁
lke	璃
pi;	劈
v]i;	赚
js/	锦
g[e;	尬
gt/	尴
xie;	熙
smei	寺
cpi	昌
hx;	贺
jwi	巾
mhe	描
bj;	捕
lfa	陵
kd	咳
st/	扇
sv/	扇
hli;	虹
mga	绵
sie;	撕
c[e	蔡
cru	催
pfe	彭
clo	宠
tt;	贪
rj;	辱
smei;	誓
hdu	盒
cz/	寸
pi/	披
lo;	搂
lle/	搂
rh;	饶
de/	跌
qv/	欠
jiu;	肌
s/u	售
xs;	巡
yme;	抑
wsa	纹
hlo;	宏
y/a	幼
pfe;	萍
vna	驻
clu;	丛
ymu;	亿
bo/	播
rdu	俄
rza	刃
ld/	蕾
rqe	挨
v/u/	仲
m[e;	迈
wde	违
bvo;	辩
rqe;	埃
sou	艘
qke/	琪
zq	灾
sru;	僧
dno	渡
beu	卑
dy;	雕
sju;	鼠
xzo	讯
l[o	辣
sqa	刷
jta;	艰
cmu	斥
qso	裙
cc/	翠
bhu;	饱
l[e	掠
xs/	询
ble	勃
xku	夕
ra	矮
yhe	瑶
cmi	赐
ne;	捏
c;o;	闯
yha	姚
sxe	瑟
kd;	渴
l]o;	谅
r;;	昂
c]/	串
goo/	沟
sxo/	涉
gui	咕
ska;	驶
sxe;	摄
ps;	贫
y;ea	辕
wga	婉
dqu	答
pfu	鹏
jpo	姜
r[e	碍
hde;	荷
hx/	荷
gpo;	冠
g];	冠
mxu	魅
mde;	玫
cae/	裁
po;	坡
hlo/	鸿
dca	邓
wq;	歪
fa/	乏
swi	申
ge/	割
wue	巫
sto	衫
b]	棒
k/o	阔
qmo;	泣
wde;	韦
h;o	恍
g]/	贯
p//	魄
bf;	柄
h]i;	患
fne	覆
mm/	蜜
yri	婴
lmeu	励
gou/	锅
bma/	陛
ve	遮
p[/	帕
gqi	咖
kq/	咖
xga	嫌
geu	胳
wq/	挖
pq;	啪
k]/	矿
qio	凄
vh;	爪
vau	爪
mgi	眠
mnu	穆
fei	啡
wje	吾
tge;	坛
pku	脾
hfo;	恒
tja	屠
boe	玻
rle;	蓉
cje;	础
yqi	曰
slu;	耸
blu;	膊
nm	逆
s/e;	寿
qua	驱
hlu/	猴
y/u	佣
ymoe	毅
j//	舅
tlu	铜
jpa	娟
mki	眯
yso	淫
fwi	吩
fd/	匪
mnu;	牧
ymu/	役
jmoo	寄
gf;	诡
xta	纤
fjo/	腐
ywa	姻
xii/	晰
yp;	渊
tfo/	亭
yyu	邀
ho;	哄
hli/	哄
sy/	骚
mne;	墓
ke/	柯
jwu	筋
cri	崔
cv;	灿
jdei;	捷
lso	淋
fja	弗
jkea	辑
gz	棍
sfa	绳
hxi	喝
ps/	频
l;oe	廊
wxi/	畏
xe;	歇
glo	裹
mhe;	苗
pvi	盼
gei	咯
lo/	咯
l/i	咯
sae	耍
s[u	煞
qso;	寝
mgi;	瞒
tt/	添
sh/	嫂
jo;	纠
ka/	慨
r;/	嚷
cka;	驰
ga;	拐
yvo;	宴
jwo	津
lgi	岚
yno;	浴
cke	耻
wge;	挽
yxe	页
yno/	誉
sru/	牲
rj/	乳
cpu;	仓
smei/	逝
hlia	喉
g]u	逛
yre	樱
jto	兼
gee	戈
hq/	哗
hai	哗
k[/	会
ya/	涯
pfe/	捧
mfu	铭
v]a	障
tte	摊
k[i	跨
tlu;	妥
rle/	揉
jze;	晋
m/o;	寞
v[;	寨
qio;	漆
wuo	污
chi;	嘲
mde/	枚
dbi	吊
qge	乾
xwe	馨
wdu/	伪
s;/	嗓
cfi	呈
qru;	卿
nge;	楠
jku/	籍
llo	裸
lvu	链
g]o	灌
kw	昆
c]i	畅
xyi;	逍
mbi	帽
y[o/	阅
d/e;	逗
dw	蹲
cai;	踩
c]o	窜
yai	哑
pq/	趴
ff/	逢
vke/	植
mda	媒
yzo	韵
vy/	昭
ysa;	尹
qto	谦
d]e	档
tp;	趟
t]	趟
vt;	沾
tn;	兔
dco	订
pj;	朴
xq	瞎
bte;	鞭
rgu	俺
jwu;	斤
cme	翅
c;u/	肠
qy;	雀
qhi	雀
q[i	雀
szo	慎
psu	盆
qtu	迁
by/	镖
fwe	芬
yai;	崖
qo;	丘
csee	蠢
mbo	庙
pt/	潘
yfu	颖
t//	拓
qj/	娶
sqa;	纱
l/o;	漏
jso	谨
ste	珊
hxu	和
pj/	仆
zr;	曾
v/o	宙
yna/	尉
xx/	屑
dri;	叮
wje;	捂
sxoo	涩
c[o	诧
cai/	柴
gte	杆
gge	杆
hgo;	涵
vca	坠
pd/	赔
v;o	涨
v]o;	涨
du/	嘟
br/	崩
xq;	薛
tfe	藤
scu/	税
ku;	枯
ymoa	译
lgo/	帘
t;o	糖
yjo;	愉
jya	骄
xvo	羡
gy;	糕
bw/	彬
yji	愚
sua	疏
hv/	翰
dje	堵
wv;	腕
mli	眸
yse	芸
xio	溪
ywu	殷
h;o;	谎
df/	鼎
gh;	稿
yoi	哟
yp/	冤
vro	症
vco/	症
kee	棵
dku	狄
ldi	咧
xpo;	湘
wgo	宛
nz	嫩
smeie	肆
zao	宰
hvo	憾
c;ui	偿
qpu	腔
li	哩
bbu	豹
gr/	瑰
jvi	鉴
b;;	绑
xyo	潇
qie	戚
jza;	郡
zh;	澡
gce;	桂
xiu/	兮
wse	雯
dte	颠
siu;	狮
lsu	邻
qme	契
h[a	骇
boi	卜
bj/	卜
cqo	差
jee;	揭
w]/	妄
kr;	坑
fau	伐
jj/	矩
s/o/	烁
z];	葬
jao	诀
bki	鄙
lno;	鹿
bae/	柏
ble;	柏
kc;	溃
vzu	朕
vou;	舟
vpo;	妆
zb;	躁
mdeo	霉
vwu	侦
d/o	冻
y[a	娅
yoo;	庸
clu/	筹
xyi/	削
xq/	削
pr	砰
gf/	耿
xiue	牺
tlu/	筒
sco	遂
xnu	旭
tq/	胎
h;o/	惶
suo	淑
cqa	叉
y;oe	痒
sni	竖
gru	龟
bte/	斑
rju	儒
yt/	嫣
vao	宅
yqe	押
wxia	胃
vku;	旨
cxu;	册
xiua	膝
jzo	浸
xga;	弦
lgei;	栏
voo/	衷
gqu	刮
tfu/	艇
g;i	岗
fne;	赴
n;/	囊
fju/	斧
jae/	颊
jpa;	疆
ljo	炉
tqe	塌
qku;	乞
w]i	旺
kh;	烤
d[u/	黛
xza	逊
jvi;	贱
bvo/	辨
lku;	狸
xnu;	叙
rxo	愕
dda	叠
qgi	遣
s;i	晌
lso;	麟
xr/	腥
lmo	粒
nk/	拟
qb	俏
v]e/	杖
vie/	芝
yke;	夷
czo	衬
zlu	佐
x]e;	巷
jge	捡
zw;	遵
sno;	塑
tle;	桶
po/	泼
tto	滩
qle	琼
hbi	昊
ft/	帆
ble/	搏
jfa	颈
ro;	噢
bc/	蹦
ga/	寡
vwi	贞
h;u;	凰
sbi	哨
cqe;	拆
rje	茹
lxi;	劣
vji	嘱
w//	沃
xpe;	厢
vq/	摘
v[/	咋
zai	咋
zdi;	咋
kw;	坤
fjui	俯
xka	媳
fni;	赋
sii	嘶
g/e;	贡
lne	碌
cki;	匙
llei	拢
tgo	谭
wr	翁
gue	辜
jdo;	竭
lgoe	廉
xxe	械
mbu	贸
fjea	辅
ffo	讽
n[i	呐
bwo	斌
lha	辽
tge/	填
qx;	窃
cy/	抄
ymoo	溢
dna	妒
xui	吁
yni	吁
soi	嗦
xte	掀
fjei	芙
qkoa	祈
d/e/	栋
vii	吱
pe	撇
pde	撇
byu	胞
jbe;	轿
cgo	禅
svo	禅
f;a	妨
fjei;	拂
j]u	倦
sqo	衰
jco/	靖
xsu	循
nle;	挪
pfei	蓬
cfuu	惩
lq/	垃
v]i/	账
bla	驳
sji	署
fjei/	甫
wge/	顽
lha;	姥
jie;	圾
rh/	熬
vs;	枕
g[e/	丐
qve	茜
yki;	咦
cxe;	厕
pte	攀
tlua	彤
yga	妍
v[e	拽
jre	荆
jmau	妓
hje;	壶
k/o;	寇
hxo	鹤
ybu	钥
v/a	骤
mho	渺
kt/	刊
viu	肢
vjo	烛
yza	孕
vva	绽
yvo/	彦
mge	棉
fjui;	俘
kr/	盔
jgo	剪
dvo;	诞
dou/	兜
lso/	凛
lfi;	岭
xyia	嚣
jvo;	溅
dku;	笛
cpu/	舱
hgo/	罕
yqi;	鸭
v[u	债
smi	噬
dru	钉
dcu	钉
goui	躬
yku/	倚
lja	缕
doi	咚
hve	撼
rf;	蕊
vku/	侄
y/u;	佑
yve;	雁
lma	隶
jvi/	践
gle	拱
mno	沐
jje	菊
fri	蜂
ynoa	裕
vbu	兆
jh/	搅
nb;	尿
rvi;	黯
dae	歹
xne	蓄
mfu;	朦
dki;	嘀
qx/	怯
dy/	叨
nla	纽
pz	聘
nm;	腻
boa	剥
byi	彪
fx/	沸
mfo;	氓
j]o	卷
b;/	榜
b];	榜
pc;	榜
lli;	逻
kd/	壳
qb;	壳
cju	储
beo	憋
pki	啤
j]e	匠
hvo;	悍
mxi	昧
blo	泊
poo	泊
pfu;	篷
t];	烫
jhu	狡
gfe	轨
xoo;	汹
xde/	携
lde	磊
xma	隙
lsu;	仑
cre	摧
mhi	瞄
llu/	胧
que	趋
nhe	挠
h;ou	煌
sve	擅
cno	卒
zjo;	卒
bf/	饼
xau	狭
wgu	丸
bxu;	惫
cli;	瞅
qa	卡
q;e/	犬
vpe;	砖
yka/	矣
lce	楞
xie/	昔
spi	裳
c;i/	裳
l/a;	骆
gno	雇
ygoi	阎
ku/	骷
yqe;	鸦
no	妞
sni;	墅
fs;	焚
pjo	谱
vja	属
hca	绘
sue/	梳
vl/	肿
kf	魁
dte;	耽
qse;	擒
dla	陡
vpe/	璋
mbe	茂
tki	蹄
pe;	瞥
tli	瞳
lli/	髅
x/a	绣
s/e/	硕
fxu	肺
cw/	参
swa	参
sta	参
zio	兹
cho;	炒
yli	邮
hla	弘
jka/	嫉
jxa	届
wr;	嗡
b[e;	把
yja/	娱
xpi	喧
viu;	脂
t;u;	膛
cpo	沧
j/o	疚
yge/	盐
bg/	扁
pto	扁
gee;	搁
mhe/	茅
tyo	滔
fs/	坟
qq;	掐
yje;	瑜
qo/	邱
tle/	桐
ywe	茵
pfei;	苹
k]i	旷
qb/	翘
hhe	郝
m/e/	蓦
v[o	诈
m/o/	沫
jre;	菁
cco	粹
vle	琢
l[u	腊
qw/	钦
yni;	喻
xvo;	宪
d]u	锻
dji;	睹
jyo	郊
jiu/	饥
kg;	侃
vt/	粘
y;a/	媛
ymoa;	谊
ks;	恳
sie/	厮
cfue	锤
dca;	凳
hao/	淮
bme;	蔽
nx;	聂
fvi	贩
tgo;	潭
pto;	翩
swi;	呻
w;e	枉
ju;	拘
vje	煮
yte	焉
vkei	址
bku;	匕
szo;	渗
lgi;	览
dw;	敦
s[e;	厦
yze	蕴
rgi	冉
xwe;	薪
rxi	呃
jzi	峻
jve	荐
zq;	栽
hhi	嚎
vio	汁
b]/	傍
tu;	秃
kee;	磕
bfo	禀
llee	珑
kg/	坎
sba	邵
mfe/	萌
vao;	窄
r;a	阮
dhi	蹈
bee	碑
ssa	婶
mdo	煤
ynoo	寓
vve	栈
vmo;	滞
t;u/	倘
h;e;	杭
xai	暇
z]/	藏
bxu/	狈
xai;	峡
lju	侣
lje	芦
mve	蔓
vre;	蒸
lno/	禄
v]u;	胀
cne	醋
t;o;	淌
sg/	伞
zk/	姊
goue	钩
ygu;	衍
qxo	妾
gai	嘎
sji;	蜀
hji	蝴
llei;	萝
m;e	莽
nja	弩
dho	祷
vmu/	稚
vze;	圳
hru	徽
yau	衙
xge	咸
l/a/	陋
se	奢
g]u;	罐
xye	霄
bme/	毙
rjo	汝
c;io	敞
mne/	暮
xui;	嘘
vlo	灼
lgoo	澜
sta;	姗
nku	倪
c/e	挫
mi	咪
jwu/	钧
dhe	捣
zb/	燥
yloo	泳
k]i;	眶
ykaa	乙
cxo	澈
h]o	焕
cle	酬
k[u	筷
xyo;	宵
jo/	揪
fna/	缚
yki/	蚁
lai	喇
cfa/	丞
lw	拎
hxi;	吓
t;i	棠
llia	咙
soe;	梭
ci/	哧
gpe	棺
x;e	璇
hvo/	瀚
gtu	肝
lgu;	敛
jmoe	剂
bqo	疤
yjo/	渔
cwi	嗔
jjo	沮
lb/	廖
lji;	虏
hbu	皓
xwi	勋
sna;	恕
n[i;	虐
yji;	虞
zoa	综
yso;	瘾
lja;	驴
s[i	晒
g[ei	卦
jqa	迦
tla	陀
kro	窥
d/a	堕
doi;	哆
pje	葡
td;	帖
dve;	垫
lja/	屡
rdu;	鹅
vui	蛛
m;o	盲
dde	碟
nfu	狞
qli	囚
vs/	诊
lgei/	揽
pdi	裴
ly	捞
lmei;	吏
vru	铮
the/	萄
vg/	盏
tfe;	霆
wo;	喔
d[ui	贷
jkaa	给
wnu	勿
kri	吭
tho;	淘
bmae	辟
pm;	辟
mxe	蔑
yto	淹
qkoe	麒
loi	喽
lmei/	栗
bra	绷
huo	惚
h;e/	桓
fp/	坊
vpei	桩
s/i	嗽
ljae	履
lne;	璐
pje;	菩
cha	巢
cno;	畜
xno	畜
wne;	兀
fge	樊
xiue;	锡
pfei/	棚
smui;	仕
suu;	倏
qse/	芹
pm/	僻
xna	絮
xce	杏
jpo;	浆
j]o;	浆
zdi/	啧
tto;	瘫
cke;	磁
gpi	冈
daa	逮
d[a	逮
coe;	搓
zci	赠
jyu;	胶
jko;	脊
rxe	噩
c/a	绰
rli	呕
jhi	嚼
jai;	嚼
xdo	谐
sxu	舍
jte	歼
cqe/	揣
caei	揣
vkeu	殖
nfe	拧
cmu;	伺
smui/	伺
lse/	霖
tla;	驼
xpo/	襄
xgu	衔
tm;	惕
vme;	掷
xxu	卸
cmo	炽
rhe	敖
cgo;	惭
k]e	框
ks/	捆
x]i	眩
cgi	蝉
mko	谜
x]o;	炫
t;e	塘
jfa;	阱
mlu	膜
hro;	亨
ymoe;	奕
mai	蚂
m[i	蚂
xru	猩
bwo;	滨
qz	沁
bai	跋
fte	藩
tgu;	舔
jpe	捐
qki;	歧
sfa;	隋
cci	蹭
vwe	甄
l[i	蜡
cii	嗤
gpu;	缸
xia	嬉
xyia;	哮
xio;	熄
qbo	窍
yju/	俞
haoo	豁
ho/	豁
h/o;	豁
lda	垒
jaei	掘
qkee	琦
ska/	屎
v[u;	乍
nx/	孽
tgu/	毯
hja	弧
hae	槐
kau	铠
xdei	挟
jwo;	襟
lku/	梨
x/i	嗅
qkoa;	祁
gpa;	纲
qjo	渠
sku;	矢
tlei	捅
k;/	扛
xle	朽
cso	忖
xou/	匈
bqe	扒
pae	扒
yoo/	雍
yre;	莺
wjui	侮
gro	闺
nke	霓
vqo	斋
jiue	稽
yyu;	夭
lsoo	沦
z/e;	揍
phi	瞟
gle;	苟
llee;	琉
yio	漪
sji/	暑
kuo	窟
dbu	钓
lsu/	鳞
ckoe	瓷
xpe/	萱
vue	株
wo/	倭
qbe	鞘
px/	沛
lu	噜
jha	绞
tfue	颓
rc/	睿
pu/	噗
wji;	唔
v]ia	幢
kqi	喀
zjo/	诅
tm/	涕
jge;	拣
yho	谣
jii	叽
coe/	葱
smeie	拭
bmau	婢
vnu;	铸
qka;	绮
jha;	剿
yzu	胤
vmue	秩
pvi;	畔
voa	粥
kf;	奎
cla;	绸
cke/	茨
jbo	觉
xwu	熏
dci;	蹬
vbo	诏
c[u	岔
bqi	叭
phi;	咆
lvo;	滥
wje/	梧
kae	垮
rbo	澳
vx	浙
dvu	甸
fea;	绯
vuo	诛
bbu;	鲍
dya	刁
jaeu	厥
wsi;	蚊
ju/	鞠
xwo;	歆
voe;	拙
mfei	茗
j]o/	眷
lna/	戮
hji;	唬
jza/	骏
btei	扳
c[i	踹
lko/	漓
yfi	蝇
lxei	擂
woo	涡
dz/	沌
tu/	凸
cia	蚩
n]	酿
t/i	唾
sle;	琐
xia;	犀
dco;	澄
cfo;	澄
zq/	哉
hau	猾
jto;	煎
vmo/	窒
xqi	虾
fji;	蝠
cyu	钞
bvoe	瓣
jii;	唧
qn;	觑
gfi	哽
rda	娥
xna;	婿
svo;	讪
gre	耕
hje/	葫
r[i	暧
jyo;	浇
hqi	嗨
s/oa	诵
ymoe/	疫
jre/	兢
xyu	箫
lji/	颅
tki;	啼
swa;	绅
ste;	杉
smi;	嗜
q];	券
dzu	遁
jlo	炯
s[e/	霎
jio	讥
ddu	迭
p;u	彷
mmu	觅
xga/	娴
mse	抿
ti/	剔
dbu;	稻
fu/	敷
xxo	泻
d[a;	怠
goe/	龚
rla	绒
hco;	讳
shu	勺
hga	函
cqi	喳
s/u;	颂
ct/	搀
ly;	撩
qfe	擎
wei	巍
fjua	脯
pju	脯
xpu;	镶
lho/	寥
y]o	漾
jha/	缴
jkei	藉
jxe;	藉
bmo;	弊
cfi;	逞
gy/	膏
coa	戳
q]/	呛
ry	凹
k/i	叩
qsu	禽
rbo;	懊
xxo;	懈
jyi	蛟
k]o	亢
pe/	呸
qte	芊
sxoo;	慑
d/i	跺
q]i	跄
sku/	蚀
qie;	栖
wxe	蔚
cgu	铲
pfeie	坪
vru;	筝
qfe;	顷
squ;	腮
bxi/	别
l]i	踉
hae;	划
d]i	当
vru/	狰
dli	踱
soi;	嗖
y]e	苑
bfu	秉
y;u;	猿
di/	堤
tlui	佟
mso	悯
lhi	唠
lbi	唠
ht	憨
vlu	肘
mje	拇
lhu	僚
pie	霹
jda	婕
yjui	禹
ksi	啃
ysu/	匀
vvo	颤
hri;	晖
c]o;	怅
lleu	聋
vf;	拯
fzu	忿
rze	韧
zou	邹
sye	梢
lxu;	肋
jlo;	窘
qvi	嵌
lgeiu	婪
xae;	辖
pjo;	浦
tv/	炭
xiia	曦
cnu	簇
llia;	螺
j]oe	酱
ts	屯
cco;	悴
kp/	匡
jmi	冀
jaui	倔
cfe;	橙
sga	陕
xh/	筱
cmi;	叱
sfi	髓
cso;	淳
jwa;	矜
vtu	詹
lfe/	菱
vkei;	芷
xro	惺
vlo;	浊
np	囔
s/ou	朔
qho	憔
jdi	睫
caia	睬
geu;	鸽
ts;	臀
dw/	吨
srue	笙
jkei;	戟
vh/	沼
ddo	谍
xwi;	昕
gji	蛊
ynou	煜
smoa;	祀
gpi;	罡
lfu;	伶
ywe;	荫
yze;	荫
suei	酥
n//	懦
rxe;	厄
rdi	峨
vle;	轴
jqu	伽
lmeo	雳
l;u	卵
cfe/	捶
ygei	檐
jkei/	棘
smi/	嗣
cqu	钗
w[;	袜
wja	妩
k]o;	炕
weu	偎
d/o;	窦
xe/	蝎
rlo	溶
pfu/	膨
vmi;	峙
jia/	缉
hau;	徊
bei	呗
xzu	衅
sqeu	砂
d/u	舵
v/a;	昼
bco	迸
vwe;	斟
yjui;	舆
jye	椒
l]e;	靓
xsu;	旬
lke;	厘
yho;	窑
wde/	萎
lgoo;	涟
geo	疙
dqo	瘩
dao	瘩
fve	梵
xqe	靴
jhu;	侥
nm/	匿
vme/	挚
vlu;	镯
dco/	兑
yhe;	尧
pau	徘
yae	芽
juu	狙
mso;	闵
bvoe;	辫
pn;	瀑
gre;	更
rhi	嗷
ljo;	庐
xwe/	芯
hdu;	禾
pfo/	澎
xfe/	邢
bva;	绊
vii;	蜘
zr/	憎
mko;	靡
mko/	靡
vjo;	褚
vvo;	湛
pje/	蒲
cqi;	嚓
kee/	珂
zai;	崽
bgi	贬
dvo/	惮
cga;	婵
t[i	嗒
jmoo;	悸
hci	晦
nxo	涅
tgo/	恬
kpo	慷
qlo	穹
vqo;	渣
tma	屉
lha/	缭
j]a	绢
fjoa	袱
yli;	黝
nhu	袅
qkoo	淇
jqe;	茄
qd;	茄
yso/	寅
sxe/	赦
sca	祟
t[e;	榻
wqi	蛙
wdei	苇
soi/	嵩
m/ei	茉
yli/	咏
zh/	凿
fzo	粪
zbi	噪
jwe/	菌
bti	蝙
sno/	庶
dku/	邸
xko/	禧
zg;	攒
hvi	旱
qgi;	虔
llei/	榴
cwe	琛
snoo	漱
tx;	忑
xae/	匣
tgi	忐
m/oa	谬
m;i	蟒
lfei	棱
dzu;	钝
slo/	悚
k/o/	廓
w;o;	惘
lnoo	漉
xxu;	蟹
lhu;	佬
yxi	曳
sjia	赎
r;e	壤
coo	忡
c]u	倡
ydo	冶
gtu;	竿
q;i	蜷
ra;	癌
chi/	嘈
cge	蚕
poo;	剖
btu	颁
c/a;	缀
tro	汀
ynoa;	谕
mju	牡
fdi	斐
mfo/	懵
fzu;	分
dlo	斗
xiei	皙
mba	缪
mla	缪
q;ei	蔷
jxo	诫
xno;	恤
doi/	咄
mgu;	馒
jhu/	矫
jhue	矫
pko	痞
jje;	橘
y;u/	氧
hci;	贿
rp	肮
jse	瑾
lbo	烙
bmae;	璧
r;e;	攘
z]e	攥
xbi/	肖
t[o	汰
nmo	溺
qtu;	铅
kai	咔
bqe;	芭
rlea	戎
hxo;	褐
gle/	巩
yyi	吆
vpo/	彰
x;oo	漩
lfei;	聆
s]e;	蒜
zoe	棕
jpi	鹃
vmi/	帜
rxi;	鄂
cne;	搐
ra/	蔼
pr;	怦
scue	穗
mjo	亩
v]ei	撰
yma/	绎
mla;	牟
zio;	咨
yte;	奄
zke	梓
qc;	亲
x]a	绚
fao	阀
hoo	烘
vmua	炙
lfu/	翎
wgo;	惋
xza;	驯
xj/	栩
yjuo	逾
xue	墟
h;ei	鬟
caei;	茬
tc;	褪
xwu;	鑫
hai;	骸
qbi	峭
mga;	缅
zbo	灶
q[o	洽
vwo	祯
xpi;	暄
ymoeu	裔
sho	韶
d]a	缎
yve/	砚
vrue	锥
vde	辙
dvoo	惦
cru;	铛
zhe	枣
h[ei	桦
sco;	邃
cje/	橱
sye;	搔
fjua;	腑
xxu/	解
yfe;	萤
suei;	枢
rxi/	遏
mnei	募
jfo	憬
rt;	庵
dyi	叼
pha	嫖
keei	苛
llue	锣
nxi	蹑
bve;	拌
dvou	奠
hcu	秽
ro/	殴
ddi;	喋
cyo	糙
dyu	貂
yie;	揖
kf/	葵
yje/	榆
yke/	颐
zbu	皂
dti	眈
rxe/	扼
tb/	眺
zia	孜
snu	簌
xku;	玺
r/u	偌
cpi;	蹿
bxe	蓓
cka/	弛
bmo/	庇
tgei	檀
xyu;	枭
l;i	螂
vki;	趾
vgi	崭
daa;	妲
dte/	掂
csei	醇
cte	掺
ymaa	驿
che	槽
qxo;	惬
lgu/	镰
lw;	抡
coo;	憧
stu	删
ypu	鸳
ht;	酣
h]o;	宦
kpu	筐
l;e	琅
vti	瞻
bye	飙
p[o	湃
ygu/	俨
qy/	跷
v[e;	栅
ste/	栅
jqe/	撅
sto;	煽
gui;	呱
jpa/	缰
cnu;	猝
gs;	衮
yhu	肴
d[e;	殆
qgo;	谴
suei/	蔬
s[o	飒
sco/	说
jca	婧
cgo/	阐
yfe/	荧
cku;	侈
fee	霏
ww;	瘟
wjei	芜
jgu	俭
qki/	崎
h[o;	亥
lmu;	俐
yji/	屿
pma	譬
jhua	饺
lleu;	垄
cli/	畴
g]e	杠
bz/	鬓
s/oa;	讼
yvi;	晏
ymoeu	弈
rt/	鞍
qa;	瘸
nlu	钮
jaee	珏
ynue	钰
kfu	傀
dri/	噔
ynaa	驭
baei	靶
yfei	萦
tye	韬
y]o;	恙
yme/	懿
vju	竺
lz;	吝
jii/	羁
xse	荀
dto	癫
pr/	嘭
gue;	菇
smoo	恃
ldu	儡
beo;	瘪
bd/	瘪
clia	踌
yoi;	呦
rlei	榕
nmi	昵
cji	躇
jzo;	烬
loi;	啰
vle/	酌
bfe	丙
xgo;	涎
dqi	哒
lxo;	冽
qme;	砌
l;oe;	鸾
yxo;	烨
vaa	翟
dka	翟
nge/	辗
ye;	噎
jua	驹
pii	噼
j/u	咎
xxo/	亵
ysa/	陨
rji	蠕
mgi/	冕
cki/	雌
rlei;	茸
yre/	瑛
tmo	剃
bqu	掰
cne/	蹙
x]e/	橡
y;ui	佯
dju;	笃
jai/	崛
kte	勘
j[u	稼
jdu	桀
yjoo	渝
xio/	汐
x/u	锈
b]e	磅
hhe;	壕
llo;	娄
coei	撮
zle	撮
jie/	玑
ckoa	祠
wqa	娲
j/o;	鹫
ngu	黏
p/e	珀
kfi	睽
spei	栓
lfa;	绫
lgoi	阑
ymi	邑
xaee	瑕
coeu	磋
snei/	粟
sje	薯
hno	沪
nxo;	讷
csi/	岑
wdo;	炜
wdee	玮
cpa	娼
yu	迂
jmui	伎
jru	鲸
fdi;	翡
b[e/	坝
kb;	铐
wqo	洼
xiia;	蹊
mxo	寐
szi	肾
ypi	鸯
bmou	敝
jvo/	涧
ko;	崆
bfe;	甭
lmu/	笠
hno;	扈
nli	哝
rce	芮
hce;	卉
jze/	靳
wuo;	诬
vae	札
bha	婊
qle;	裘
feo	扉
cpo;	疮
dti;	巅
wne/	坞
svu	膳
rxu	鳄
n[e/	捺
dbo/	悼
jge/	茧
wja;	毋
sjia;	曙
xvu	馅
blu/	簸
b/;	簸
te;	忒
jieu	奇
slu/	叟
spei;	拴
mqa	嬷
suu/	稣
bmoe	痹
y;ei/	垣
gdi	蛤
hai/	蛤
jvoa	谏
gro;	羹
lmo;	沥
rdi;	蛾
hjee	瑚
rlo;	熔
clo;	惆
cju;	雏
x;u	饷
rbe	拗
n/e	拗
lhou	燎
ymou;	熠
xwei	薰
fge;	蕃
lje;	捋
l[u;	籁
mhei	髦
jnu;	飓
blue	簿
bnu	簿
tha;	迢
vao/	闸
s/u/	狩
sqo;	鲨
xiia/	蜥
vcoo	惴
k[u;	胯
qhu;	侨
sba;	劭
pro	烹
gpi/	咣
you;	攸
cju/	锄
xye;	硝
hvu	颔
roe	鸥
tfua	滕
h;oo	寰
wso	紊
jye;	蕉
clue	稠
mai;	蟆
g/e/	垢
kae;	楷
cro	炊
xwo/	忻
bfo;	炳
tgua	腆
byo	褒
qlo;	酋
zp/	赃
nt	拈
ngei	拈
sueie	抒
sjo	孰
rho	袄
g[o	褂
rja	孺
ytu	胭
vce;	赘
dka;	嫡
jye/	礁
c/i	啜
qgu	钳
l]i;	晾
jrei	茎
sca;	隧
llo/	窿
cfaa	骋
c;a	嫦
lje/	掳
kge	槛
g;e	莞
wgei	莞
phe	瓢
ybi	曜
jnu/	锯
cpua	猖
xaa	遐
t[i;	蹋
sou;	飕
zm/	渍
hro/	麾
wdua	猥
goue;	篝
xze	殉
jqei	枷
ygi;	蜒
jhui	皎
jme;	霁
xjo	诩
jbo;	窖
vka;	咫
mfei;	檬
pru	乒
xiuo	奚
yu;	淤
fjuo	父
snoo;	溯
dyo	凋
f;a;	纺
lkue	篱
mmo	泌
bbu/	刨
phu	刨
qhe;	樵
cv/	忏
r];	盎
lmo/	戾
re	阿
jji	咀
ymi;	屹
c/o;	冲
k[e	挎
gyo	羔
ype	殃
gro/	庚
mhi;	淼
dvoo;	淀
r[a	隘
j]a;	绛
yra	缨
cve	璨
jyi;	跤
qpu;	锵
rze;	摁
q;o;	痊
psa	嫔
vwe/	臻
mso/	泯
mdo;	糜
mni	睦
my;	喵
pya	缥
rn;	褥
ygeu	魇
wz;	汶
cgu;	馋
djo	渎
wt/	蜿
ko/	抠
re;	诶
dwe	墩
dme;	棣
t[i/	沓
rdi/	喏
hco/	诲
pae;	琶
mha	缈
dma	缔
yze/	酝
dqe	耷
bmae/	弼
jgei	柬
lloo	浏
kh/	拷
d/u;	剁
smeiu	柿
pke	琵
yko/	沂
ngei;	捻
blui	帛
nfe;	柠
rku	饵
lbe	撂
wda;	娓
pp	乓
keea	轲
rge	髯
pra	娉
jsa	尽
gre/	圭
cfee	璀
tqe;	苔
tae	苔
f;u	肪
ssi	吮
vji;	瞩
vli	啄
wdi;	帷
guu	箍
vpi	蟑
dzo	炖
gfe;	梗
sye/	捎
hei;	嗬
mle;	蘑
xiiae	唏
q[e	鹊
jieu;	矶
qpo	羌
gdi;	骼
squ/	筛
lkua	鲤
xiou	羲
qkoa/	祺
kc/	馈
vnu/	伫
ymao	羿
bye;	苞
lkue;	犁
sxei	啬
xgu;	舷
cnei	矗
pko;	癖
cxu/	掣
bge	匾
yfo;	瀛
mmo;	谧
l/e	珞
ynue;	毓
n[o	衲
kao	恺
wda/	纬
d/o/	惰
yri;	嘤
ymoa/	诣
dmo/	谛
zhe;	藻
lp	啷
sdu;	佘
xai/	黠
smua/	饲
qli;	虬
dko	涤
lla;	骡
bou	钵
hge	邯
ssu	笋
jxe/	芥
xwei;	醺
jhui;	佼
szu	舜
w/i	龌
zt	簪
tgoe	痰
lsoa	论
rli;	蹂
cxo;	恻
h;u/	簧
srue;	甥
mgu/	腼
cgou	单
svo/	单
tla/	驮
bwa	缤
cgoo	潺
lhu/	獠
fau;	筏
dcu;	锭
qq/	阙
q[o;	阙
y[u;	粤
kei	瞌
lgee	琏
c/i;	龊
vre/	椎
soia	唆
xni	煦
mdi	嵋
fti	幡
ymao;	翌
vtu;	毡
tve	碳
bhu/	鸨
msoi	闽
lz/	躏
tfi	蜓
xoi	咻
hve;	捍
nmi;	睨
ht/	鼾
jje/	桔
rha	娆
jaei;	抉
qri	蜻
h;uu	徨
dai	嗲
ngeu	碾
kpi	哐
lsou	粼
cci;	啐
x[o	谑
tmi	嚏
beo/	鳖
v[e/	榨
tmu	倜
jmue	稷
c]u;	篡
wni	晤
vbo;	肇
zqi	咂
vla	帚
lloe	瘤
cri;	瞠
rji;	嚅
c]o/	怆
ngei/	撵
dp/	裆
xvu;	腺
xya	骁
kde	坷
p;i	螃
vlo/	冢
gnu	锢
bwo/	濒
h;i;	蝗
fro;	烽
swe;	莘
lne/	辘
qbe;	撬
wc	瓮
gz;	亘
vyu	钊
llue;	篓
tka	缇
cso/	宸
v/i;	胄
dae;	鞑
lfo;	羚
sfa/	绥
jtu	笺
hw/	荤
qmu	迄
jni;	踞
j;o;	桨
yooo	慵
jzi;	噤
h;i/	幌
sti	跚
tgoa	袒
h]o/	浣
lgeiu	榄
h]oe	痪
tje	荼
yto;	阉
yxu	腋
tli;	骰
pn/	曝
s]o	涮
vli;	踵
jno;	炬
h]oo	涣
smuia	俟
rau	皑
mfi/	瞑
x]o/	渲
sle/	擞
lni;	赂
yto/	湮
lnei	麓
kru	铿
pjei	埔
l;oe/	峦
jpo/	涓
jue	掬
y]o/	怏
mdei	莓
cce	萃
zii	呲
pg/	蹒
rhe;	鳌
l[i;	睐
yni/	昱
hju;	和
h/u;	和
jro;	旌
l/e;	摞
fxi	吠
pjo/	濮
rto	谙
thi	啕
ymea	轶
t;e;	搪
lla/	陇
wga;	纨
yro	膺
gyu	皋
rae	霭
ymi/	呓
gge;	橄
lsa	纶
d/ei	垛
nxi;	嗫
voi/	盅
haia	踝
zpe	臧
xioo	淅
jki	岌
d[ui;	岱
pjee	璞
jta/	缄
ypu;	秧
rhu	翱
ljie	卤
h/u/	逅
yxe;	靥
pgu	磐
hxi/	壑
lgoe;	斓
ymoeo	翊
l;oei	挛
sta/	叁
tlui;	佗
hdo;	阖
sluo	怂
jgei;	戬
jko/	汲
yse;	垠
jli	迥
nfi	咛
xxua	邂
qkei	杞
d/oe	痘
sbu	臊
rlei/	藕
pma;	媲
mdo/	湄
l[o;	癞
vde;	辄
rhe/	獒
kxo;	恪
lmeu;	砾
jcoe	痉
tc/	蜕
ye/	椰
cio	差
squi	仨
v/a/	纣
nd	馁
wji/	蜈
gh/	镐
yho/	窈
ccu	秤
l;oo	粱
fjea;	辐
bxo	悖
csoo	涔
xdu/	偕
wxo;	渭
bvoo	汴
ymia	蜴
wdei;	桅
yjai	隅
mhu	卯
rbe;	骜
fjuo;	孚
yjia	禺
hjee;	琥
cjei	杵
yee	掖
jiia	畸
yxi;	晔
re/	婀
hve/	菡
gai;	噶
tgi;	昙
tte;	坍
ylu;	俑
lnoo;	滤
vuu;	侏
lhoo	潦
soo	挲
lleu/	硫
fcu	俸
pgi	蟠
ymea;	弋
bp/	梆
fnaa	驸
jkue	笈
csoo;	忱
yla;	恿
jwua	龟
xua	胥
ksa	垦
tho/	窕
dto;	滇
swe/	珅
pji	圃
yii	咿
xku/	徙
v]o/	瘴
f;u;	舫
gdi/	嗝
nc;	泞
mhei;	藐
gv;	赣
yri/	鹦
kfe	逵
sneu	戍
xxe;	榭
kqe	揩
xiei;	熹
cgi;	蟾
maeo	霾
nt;	蔫
bli	跛
qkia	岐
qku/	脐
qlo/	糗
t;i;	螳
bji	哺
lni/	鹭
goi	蚣
wdi/	嵬
vdo	褶
t/o	恸
j]u;	隽
y[e;	玥
zko	籽
fjuo/	釜
gai/	剐
jou	鸠
lseu	磷
soo;	娑
sma	巳
cgoa	谄
zmo	恣
wxu;	猬
lbe;	酪
pie;	丕
mfoo	溟
ssu;	隼
yne/	芋
jmi;	觊
ygue	筵
dma;	娣
ds	盹
hdo/	涸
hdoe	劾
hdu/	颌
speu	殇
y[e/	轧
guo	沽
snoo/	愫
ype;	鸢
dve/	玷
dge	掸
pjoo	溥
cio;	疵
wgu;	皖
yhe/	杳
dnu	镀
yio;	祎
wjee	鹉
pju;	匍
wa/	崴
qui	岖
mvi;	幔
goi;	蝈
b]u	镑
ymua	臆
ygui	偃
woi	蜗
kv;	瞰
nlu;	侬
dto/	郸
lga	缆
mxo;	袂
q;o/	诠
dju/	犊
mle/	摹
s[i;	蟀
lqa	邋
jzo/	竣
jmaa;	骥
smoo;	泗
vmoe	痣
bwe	贲
d/u/	胴
tlo;	潼
smuo	弑
fjua/	匐
jya;	姣
b]o	谤
vve;	蘸
xiiae	蟋
w/o	渥
hjo;	浒
qui;	蛐
hdoi	阂
n/o	糯
yzo;	愠
jiue;	嵇
yxo/	谒
yhu;	舀
pke;	否
lfi/	呤
bwe;	槟
bri	嘣
nlu/	脓
vpei;	樟
vooo	忪
vde/	蛰
v[i	咤
fnui	阜
vri;	峥
rjo;	濡
t[ia	遢
dge;	担
nhe;	瑙
dye	碉
fuu	孵
rdo	讹
ykaa;	彝
qkuu	颀
v]u/	篆
yjui/	臾
tlei;	椭
qio/	沏
psi	颦
qui/	蛆
xho	淆
yjei	揄
y[eu	压
kxi	嗑
dgi	踮
g;u	犷
lmeii	荔
qou	鳅
ygoi;	闫
wdai	隗
blo;	渤
mlu;	馍
jgu;	锏
mdei;	楣
sze	蜃
l/u	遛
vqe	查
gpu/	倌
ywu;	氤
xue;	戌
lsi	嶙
kfu;	馗
kce	匮
yde	揶
peu	胚
cmo;	啻
cme;	敕
snu;	夙
jqee	珈
qyu	锹
bce	摒
rku;	迩
joi	啾
ynia	峪
boe;	菠
fnue	馥
cfei	槌
ljo/	褛
ykia	贻
bleu	礴
ts/	豚
ywu/	氲
tp/	湍
ytu;	腌
v[i;	蚱
bze	殡
pki;	毗
pae/	耙
fdo	诽
lgoa	褴
cco/	瘁
b]i	蚌
lju;	铝
k/e/	蔻
qmu;	憩
mhu;	锚
l[o/	濑
yse/	耘
bku/	俾
zoe;	鬃
sqo/	裟
rge;	苒
hfe	蘅
ylu/	鱿
t;ui	傥
jqa;	袈
cau/	豺
tfi;	町
doe	掇
pie/	坯
jaeu;	戛
vni	贮
sjo;	塾
pye	剽
ny	孬
cao	衩
lbu	镣
wneu	戊
j]a/	犟
yle;	酉
w/e	斡
zqe	匝
jdo/	诘
jaei/	攫
h;oo;	潢
qgi/	黔
you/	臃
yria	罂
smea	轼
xne;	酗
lhi;	嘹
bga	阪
rlo/	冗
gce/	桧
msi	皿
nt/	囡
c/e;	辍
yjuo;	觎
jzoo	浚
rzo	闰
j/u;	臼
bdo	蹩
byu;	煲
cno/	怵
tsi	囤
w;i	罔
ysi;	蚓
caeu	碴
jlu	灸
qoi	蚯
hhi;	嗥
qve;	堑
vwu;	箴
cgoa;	谗
rli/	嵘
llue/	箩
jgeu	碱
bhe;	葆
nko	旎
vwo;	谆
z/o;	粽
ddu;	牒
ljoo	泸
gcu	刽
dko;	诋
vsa	缜
yhu/	爻
rm/	贰
rbe/	坳
jgi	睑
jqei;	葭
ynau	妪
l/u;	镂
gfa	癸
bqu;	笆
rs/	壬
v/aa	绉
pre	抨
pl;	叵
jiue/	箕
tlei/	坨
jdei/	颉
c[a	姹
joe	赳
hvou	焊
ccoo	淬
ysaa	纭
bne	埠
ypo	泱
ytoo	恹
vwei	榛
jbe/	酵
l;oei	銮
jkui	佶
kb/	犒
vue;	茱
rzu	饪
l;oei	孪
lmeu/	砺
jni/	遽
jei	嗟
g[u	钙
yvoa	谚
kw/	鲲
mloa	谟
sou/	馊
vmue;	雉
siau	虱
kpo;	糠
vzi	赈
gqu;	旮
bya	骠
xsi	峋
tai	跆
jkoe	瘠
tyi	饕
ymui	佚
zio/	淄
yjoa	谀
byu/	镳
d/oa	读
nv/	廿
kci	喟
llui	偻
llaa	绺
gui/	骨
tlo/	沱
cou;	囱
ygoe	兖
mbo;	袤
jiaa	畿
vooa	诌
bs;	苯
tyu	佻
xyu/	魈
dha	屌
jao;	谲
jro/	泾
jaua	獗
jaia	蹶
kna	绔
bhe/	雹
lai;	旯
rko	洱
hsu	馄
cvi	粲
ssi;	哂
vx;	蔗
tsu	饨
z]a	奘
she	芍
soo/	淞
yjua	腴
wto	剜
fso	汾
xue/	顼
lgoo/	濂
fdi/	蜚
yseu	殒
ybu;	鹞
zha	蚤
jqo	浃
bge;	坂
rxia	颚
wjo	忤
zmi	眦
hce/	彗
xti	暹
ngeie	赧
goui;	佝
y[u/	钺
le;	嘞
greu	硅
d[e/	玳
ylia	蛹
gyu;	睾
yjee	盂
lzu	赁
mbe;	瑁
wna	骛
d]o	宕
z;	纂
yvei	堰
j/e	厩
qie/	萋
pxi	帔
c[e;	杈
yza;	熨
t[e/	挞
jzei	觐
xpou	煊
c]u/	钏
x]oo	泫
jca;	迳
sva	缮
scou	燧
cga/	孱
mz;	懑
j/e;	柩
cho/	漕
hju/	鹄
ktu	龛
jvua	饯
tx/	餮
w/i;	幄
gji;	鹘
jnui	倨
hroa	诙
zcu	锃
q;ei;	颧
pia	纰
rho;	鏖
qru/	氢
xee	楔
lke/	藜
viei	栀
smoa/	谥
xpa	骧
jiuei	犄
wee;	葳
ciu	魑
goei	聒
cwe;	椿
yau;	伢
mgo	谩
wna;	鹜
yte/	燕
spo	闩
yfu;	颍
hho;	濠
rzu;	仞
mgua	鳗
ylia;	踊
wdo/	痿
gru;	皈
lka	骊
jda;	孑
gli	帼
lu;	撸
xke;	檄
boi;	啵
y/e	柚
kcu	篑
cfai	陲
lvo/	潋
zw/	樽
rhee	遨
bluu	舶
pjei;	莆
vni;	蛀
cwe/	抻
caei/	搽
lmui	俪
x]u;	铉
h/i	嚯
vlei	茁
jli;	韭
byua	膘
mfei/	酩
l;e;	榔
mga/	娩
hvoo	汗
wsu	刎
mse;	扪
vpoo	漳
dru;	仃
cmu/	饬
yie/	壹
bmoa	裨
pko/	裨
xza/	巽
cni	黜
pp;	滂
lkei	鹂
y;uu	徉
qpa	戕
gfe/	埂
rza;	纫
g[o;	溉
jaua;	胛
xwu/	锌
h;ui	遑
jiia;	跻
hy	蒿
t[u	钛
msi;	岷
pqe	葩
h;eu	磺
svoo	汕
gpua	肛
vooo;	涿
jyu/	鲛
bmi	睥
l;oo;	滦
rsu	稔
qxu	锲
c;uu	徜
xgo/	冼
vpu	獐
hci/	喙
h/o/	讧
rtu	氨
bho	褓
se;	赊
wgei;	菀
pl/	鄱
gci	炅
cseu	碜
qpu/	戗
lfuo	瓴
dfe	酊
n[u	钠
jpu	镌
ylue	铀
jdou	羯
woe	挝
q;oa	襁
vjo/	渚
jcu/	胫
jui	雎
dke	砥
qju	衢
fxu;	狒
qto;	骞
hcei	荟
hau/	华
hbi;	号
vrei	正
dveu	石
xzo;	汛
sau	色
g]u/	盥
yai/	睚
lmeiu	栎
tleu	砣
hcou	烩
hpe	夯
jdeie	拮
sma;	驷
lve	殓
bmi;	哔
xzu;	徇
cni;	蹴
k[o	忾
vso	疹
tlua;	鸵
yzee	韫
quo	祛
stu;	膻
quia	黢
zx	仄
lmi	唳
y;ou;	烊
y]ou	烊
spa;	孀
dcu/	腚
djui	牍
dvu;	佃
svi	赡
m/u;	秣
q[e;	榷
ldu;	镭
s/ue	铄
r[a;	嫒
bou;	饽
csoa	谌
nxi/	啮
llia/	蝼
wdoi	闱
gyu/	篙
qwa	逡
bzu	膑
h;a;	隍
qc/	罄
jaeii	蕨
nki	呢
lsi;	囵
ljei	橹
sri	睢
lki	喱
hpo	肓
ljei;	榈
s/a	绶
s/ou;	槊
lki;	罹
ghe	槁
jeu	秸
bho;	裱
mhu/	牦
zko;	滓
fdu	腓
fae	砝
smue	舐
czo;	谶
ggu	秆
rse	荏
hjua	斛
jmae;	暨
yvoo	滟
sua;	纾
bqo;	粑
k;o	诳
lhoo;	寮
csoe	鹑
nja;	驽
hji/	囫
lau	徕
mka	弭
qye	橇
lmoe	痢
h;ia	圜
cpe;	撺
gte;	柑
jfu	儆
l;u;	魉
rza/	妊
viu/	氏
mdei/	酶
pho	庖
ymaa;	缢
zju	俎
jmua	鲫
xge;	藓
bau	佰
vmoe;	痔
goua	觥
mo;	哞
k]u	伉
r/o	怄
gue/	轱
bce;	泵
gge/	擀
kei;	蝌
cna	绌
soe/	蓑
y/u/	釉
ymea/	翳
qmo/	讫
ve;	蜇
vdei	蜇
vweu	砧
tgeu	殄
rxei	萼
ykua	胰
cji;	蜍
yu/	瘀
guei	鸪
xve;	霰
vx/	鹧
hz/	诨
jvui;	僭
bva/	弁
mgo;	湎
jdeiu	栉
coi	蹉
tke	醍
qce	磬
lloo;	泷
lhe	蓼
blue;	铂
gne	梏
vzo	鸩
wte	豌
zoi	嘬
y;oe;	疡
qhe/	荞
lbo;	涝
hfi	蛔
mz/	焖
vko	祉
w;u	魍
tli/	跎
c/u	锉
vmei	桎
vdei;	喆
swa/	娠
wdoa	诿
roe;	瓯
dteu	殚
mdu	镁
jqo;	痂
gpua;	胱
cjua	刍
hjei	醐
rlou	糅
bmoo	愎
yveu	赝
yvi/	唁
jqu;	笳
lhi/	崂
jji;	踽
qkua	鳍
vwi;	帧
pga	骈
qtu/	仟
ldo	羸
vdo;	谪
swu;	狲
pgu;	槃
hre	珲
vmia	蛭
ykoe	痍
hjua;	猢
ygui;	鼹
tmo;	悌
lmeii	莅
me;	咩
tfou	誊
svu;	鳝
wdia	韪
jaia;	噱
lkui	俚
gx;	硌
k[u/	脍
glei	汞
nb/	淖
pw/	姘
kce;	聩
qloo	泅
ywi;	喑
dka/	绦
vau;	铡
yzo/	恽
qlou	遒
lhoe	痨
dli;	蚪
jkeii	蒺
spu	觞
qme/	葺
d]o;	煅
fdo;	悱
qle/	茕
dvee	靛
kpo/	诓
blue/	箔
rke;	珥
jaia/	岬
nxu	臬
goua;	肱
bxo;	焙
vmei;	鸷
mfia	蜢
yle/	莠
q;u;	铨
rvu	胺
jse;	堇
v]ia;	嶂
jaue	钾
xti;	跹
rte	鹌
ciu;	笞
rn/	缛
c;e/	椽
thei	苕
tleia	酮
wna/	婺
hduo	貉
y/i	囿
xkue	铣
coee	舂
dge/	碘
v]ua	馔
vuu/	铢
fjoo	涪
lnu;	氯
dau	傣
dlo;	度
mxu;	篾
mku	猕
pieu	砒
vpi;	颛
qioo	柒
ykua;	饴
wdei/	圩
pbo;	疱
yjia;	圄
glei;	枸
xouo	貅
lmi;	蛎
sli	唢
keo	窠
lfia	囹
xdei;	撷
cpui	伥
n[o;	疟
nlui	傩
g/o	诟
zii;	嗞
gqi;	赅
vqe;	楂
dvu/	氮
yjue	竽
jdeu	碣
rxo;	谔
haue	铧
mhue	铆
cjo	滁
lsou;	遴
c;ua	舛
jme/	荠
keu	稞
joo	阄
jaeii	荚
rha;	媪
ymoo;	悒
hnu	笏
gfi;	晷
y/o;	宥
vmuo	豸
bze;	摈
fjuao	凫
qta	阡
p/o	粕
x;oe	癣
f[;	珐
llua	馏
ysi/	龈
l;u/	锒
mfia;	虻
ngu;	腩
rqi	吖
r;o	瓤
jkeiu	楫
nxu;	镊
l]o/	阆
skeu	豕
b//	擘
dre;	玎
xoua	馐
wdoo	潍
byi;	龅
dji/	黩
qkei;	芪
bteu	砭
jvua;	腱
qxe	挈
dca/	怼
sva;	嬗
pku;	貔
paei	杷
roo	讴
gx/	铬
h]oo;	沆
fni/	蝮
wgo/	烷
kou	箜
qz;	揿
hfe;	茴
lju/	鲈
mhi/	昴
gha	缟
sbo	瘙
xgoe	痫
fge/	矾
nau	氖
xiou;	烯
jhue;	铰
vla;	妯
mbe/	耄
n/e;	搦
x;a;	飨
gpua/	鳏
gno;	痼
fno;	讣
n;u	馕
ngu/	鲇
s/a;	妁
rxei;	垩
pke/	枇
mmo/	幂
mha;	蟊
qkei/	萁
g]e;	鹳
xui/	盱
t;a	帑
caui	侪
lka;	娌
bto	煸
ziou	孳
rci	蚋
l;oei	脔
r/u;	箬
q;ei/	樯
ds;	趸
jnei	苣
yjei;	萸
jgo;	謇
bka	妣
voia	啁
qfu	氰
jte;	蒹
woe;	莴
ysua	夤
ynao	鹬
rxu;	腭
gru/	鲑
gv/	淦
gfu	鲠
hhi/	蚝
xxoo	瀣
qka/	骐
kue	堀
z/e/	柞
gto	泔
mfu/	锰
h;ia;	蟥
hy;	薅
clia;	嵯
sii;	蛳
bmu;	篦
bmei	荜
cyo;	焯
qve/	芡
rhee;	螯
ykia;	眙
ymua;	肄
qge;	荨
dde;	耋
pau;	俳
yiu;	铱
slei	薮
jiueo	笄
mgo/	渑
ckei	豉
yloe	疣
nxu/	镍
ljea	轳
spo;	熵
szo/	瘆
vne/	杼
gjo	诂
ngua	鲶
fjue	氟
hfo/	洄
bya;	孢
cwei	郴
lmi/	詈
rleii	鞣
fji/	蜉
rlee	耦
lfia;	蛉
dtu	箪
qtuu	愆
h/ei	藿
fxo	痱
yua	纡
sze;	葚
lkue/	黧
bmea	毖
kpi;	髋
dke;	坻
lki/	蜊
nhu;	铙
t[o;	漯
sva/	骟
bqe/	捌
d]e;	椴
spei/	墒
kxo/	溘
ylui	牖
tpi	蹚
xmo	阋
qji	龋
ymuo	刈
qto/	悭
jpou	蠲
hne;	瓠
gee/	圪
vmea	轾
fue	麸
ziu	锱
gje;	瞽
ckou	糍
pji;	蹼
xau;	鳕
zlu;	偬
sse;	榫
zku	秭
bto;	瘢
phe;	殍
dce	碇
dce;	碓
jaa	孓
sqoe	痧
yooe	痈
goei;	埚
yooe;	壅
hno/	怙
ymoeu	癔
yfo/	潆
lsei	檩
clo/	痤
dei	嘚
sueii	菽
jyei	茭
xte;	酰
hde/	菏
zoo	诹
jrou	粳
zt;	糌
gdu	舸
bbi	趵
lmeiu	枥
gdu;	膈
bwu	傧
ljie;	鸬
nae	艿
fwe;	酚
dje;	椟
h[u	氦
plu	笸
dgo	疸
q;eia	醛
hlue	篌
vkei/	枳
vkeia	酯
thei;	髫
h;a/	缳
nja/	孥
lmoo	溧
h/ue	镬
jsa;	卺
cwa	皴
mla/	鍪
gte/	坩
lleua	砻
tgou	郯
bmu/	筚
kfi;	跬
mke	醚
jxi	蚧
t[u;	肽
gva	绀
hte	顸
vto	谵
xsu/	鲟
xka;	屣
ckou;	鹚
jjo;	焗
jeo	疖
q]o	炝
lsi/	啉
xieu	硒
yjuie	伛
guia	蛄
xge/	燹
sya	缫
bmi/	髀
sooe	凇
pkei	鼙
qpo;	悛
rze/	轫
gtei	苷
dio	羝
nxe	蘖
pki/	蚍
rhei	桡
n/e/	耨
qtoo	搴
fde	榧
yaia	蚜
rxea	轭
jwo/	皲
viua	胝
ylia/	蝣
fnua;	鲋
pfeu	硼
xke/	葸
t;o/	溏
feu	鲱
rno	溽
fjoo;	滏
t]/	彖
smee;	耜
lkee	嫠
lkuee	锂
qju;	劬
mt	颟
tlia	曈
bmoo;	濞
pku/	郫
z/o/	怍
mgia	螨
ynoi	阈
vwu/	肫
kfi/	蝰
yjia/	蝓
kfia	暌
lleii	蒌
nxe;	颞
dyu;	鲷
xzu/	囟
x/o	溴
bs/	畚
dvoe	癜
gs/	辊
pyi	嘌
tro;	烃
cre;	柽
bkue	秕
jpe;	豇
k/i;	蛞
h;oe	颃
dki/	骶
bbua	鳔
q[i;	髂
l/o/	瘘
vwua	胗
bzi	髌
x]ei	楦
xto	籼
hou	齁
kxa	骒
ywe/	堙
quo;	袪
t[ei	酞
ziu;	鲻
kxu	氪
