去	q
我	w
在	z
他	t
有	y
是	s
人	r
的	d
也	f
个	g
还	h
就	j
可	k
了	l
想	x
从	c
着	p
不	b
没	m
这	v
你	n
一	yi
来	la
说	so
上	s]
到	db
大	d[
们	mw
道	dbo
那	n[
么	me
地	dm
子	zk
下	x[
出	cu
时	sk
看	kv
要	yb
她	tq
中	vo
中	v/
然	rg
里	lk
为	wd
为	wx
过	g/
自	zm
好	hh
得	de
得	dd
会	hc
天	tt
心	xw
后	h/
以	yk
小	xh
都	do
和	hd
对	dc
能	nf
起	qk
之	vi
手	sl
而	rk
只	vii
只	vk
生	sr
使	sku
身	sw
头	tl
样	y]
事	sm
多	dou
己	jk
家	jq
面	mv
知	viu
开	kq
如	rj
无	wj
现	xv
很	hs
点	dg
前	qg
发	fq
发	f[
经	jr
情	qf
把	ba
老	lh
些	xe
话	h[
已	yka
又	y/
声	sre
意	ym
于	yj
回	hf
笑	xb
所	slu
但	dv
眼	yg
成	cf
方	fp
年	ng
见	jv
当	dp
女	nj
真	vw
两	l;
力	lm
气	qm
用	y/u
长	c;
长	v;
动	d/
间	jt
间	jvo
国	gl
走	zl
让	r]
被	bx
给	gd
正	vc
问	wz
打	da
明	mf
儿	rku
法	fa
才	ca
几	jku
行	h;
行	xf
三	st
定	dco
此	ck
进	jz
再	z[
种	vl
将	jp
实	sko
同	tli
最	zc
本	bs
向	x]
分	fw
十	ske
学	xa
高	gy
第	dmu
感	gg
怎	zs
神	ss
听	tr
边	bt
作	z/
其	qke
吧	bq
却	q[
口	kl
觉	ja
啊	rq
因	yw
白	bau
次	cm
军	jw
做	z/u
外	w[
门	ms
光	gp
风	fr
主	vj
住	vn
果	gli
与	yje
全	q;
二	rm
候	h/u
公	go
相	xp
相	x]e
吗	mq
等	df
别	bd
色	sx
死	skeu
张	vp
部	bn
太	t[
日	rmi
少	sh
少	sb
战	vv
理	lke
直	vke
重	cl
重	v/u
王	w;
像	x]u
脸	lg
比	bk
快	k[
何	hdu
水	sf
名	mfu
体	tk
呢	ne
东	doe
叫	jb
西	xi
应	yr
应	yc
便	bv
便	pg
放	f]
马	ma
难	nga
轻	qr
更	gc
美	md
位	wxu
关	gpo
机	ji
接	je
先	xt
文	ws
处	cj
处	cn
并	bc
望	w]
常	c;i
完	wg
四	smi
飞	fe
师	si
者	vd
安	rt
清	qro
刚	gpi
跟	gw
月	y[
信	xz
山	sti
爱	r[
内	nx
龙	ll
空	ko
空	k/
带	d[e
找	vh
原	y;
入	rn
李	lkei
连	lge
吃	ci
场	c;e
平	pf
思	sii
林	ls
变	bvo
什	ssu
由	yl
受	s/
亲	qw
命	mc
目	mn
强	q;a
男	ngi
任	rz
该	gq
路	ln
车	ce
今	jwu
海	ha
加	jqa
远	y;e
活	hl
特	tx
解	jd
电	dvi
世	sme
性	xc
表	bh
许	xj
它	tqo
立	lmo
黑	he
金	jwuo
红	hla
花	hq
转	v;e
转	v]
总	zlo
算	s]u
城	cfe
队	dca
孩	haa
反	fg
工	goe
始	ska
满	mg
新	xwo
兵	br
物	wn
离	lko
非	fei
虽	sri
云	ys
似	smu
万	wv
至	vm
干	gt
干	gv
通	to
认	rzo
失	siu
火	hlo
哥	ge
士	smei
五	wje
惊	jro
魔	ml
竟	jc
姐	jda
乎	hu
剑	jvu
往	w;u
量	l;i
量	l]
早	zh
结	jdaa
怕	p[
流	llo
突	tu
坐	z/uo
斯	sie
音	ywo
紧	js
指	vkei
拉	lq
杀	sq
半	bvou
记	jm
且	qd
利	lmu
合	hduo
倒	dh
倒	dbu
书	su
度	dn
微	we
步	bni
教	jy
教	jbe
喜	xk
越	y[e
影	yf
谁	sd
冷	lf
深	swo
告	gb
落	l/
象	x]ua
容	rl
怪	g[
传	c;u
传	v]u
钱	qgu
提	tke
言	ygo
随	sfa
每	mdu
双	sp
服	fj
击	jie
武	wjee
哪	na
数	sj
数	sn
站	vvo
奇	qkeu
房	f;
管	g;
灵	lfa
刻	kx
题	tki
衣	yio
周	vou
静	jce
伤	spu
百	bae
拿	nau
妈	mqa
办	bva
星	xr
化	h[u
功	goei
绝	jaa
系	xm
般	btu
必	bm
业	yx
尔	rkua
件	jvui
血	xd
血	x[u
代	d[u
精	jrou
弟	dmo
终	voa
近	jzu
条	th
青	qre
界	jx
司	sia
整	vf
欢	hp
字	zmo
晚	wgi
民	msa
帮	bp
切	qe
切	qx
即	jka
忙	m;
交	jyo
或	h/e
暗	rv
夫	fu
员	y;i
根	gwe
石	skeui
哈	hqi
夜	yxo
父	fn
制	vmu
友	yle
阿	rqa
息	xiu
冲	co
酒	jl
保	bhu
片	pv
形	xfe
阵	vz
南	nge
决	jao
请	qfo
各	gx
报	bb
兴	xro
兴	xco
阳	y;a
急	jkua
语	yjo
令	lc
错	c/
及	jkau
刘	lloe
极	jke
识	skoa
备	bxu
慢	mvo
雪	xae
苦	kj
若	r/
领	lfu
收	soa
底	dk
尽	jza
准	vs
看	kt
华	hau
华	h[ui
答	dau
众	v/uo
千	qt
要	yy
消	xy
视	smo
罗	lli
敢	gga
留	llu
克	kxe
乐	lx
乐	y[u
够	g/u
跑	ph
显	xg
嘴	zf
官	gpoo
断	d]
未	wxe
势	smeie
句	jn
求	ql
计	jmo
论	lz
达	dae
则	zd
害	h[o
八	bqu
单	dt
久	jlu
脚	jh
德	ddu
元	y;ee
脑	nh
楚	cje
雨	yjei
睛	jri
响	x;
刀	dy
确	q[e
玉	yn
得	dduu
沉	cs
北	bdi
格	gde
停	tf
陈	csa
市	smoe
朝	vy
朝	ch
喝	hei
族	zj
江	jpo
团	t;
母	mj
章	vpo
装	vpoe
亮	l]o
客	kxo
照	vb
乱	l]u
易	ymi
足	zji
依	yiu
黄	h;e
修	xo
破	p/
台	ta
球	qle
呀	yq
院	y]a
送	s/o
包	by
义	ymo
诉	sno
攻	goeie
丝	siaa
围	wdi
玩	wge
待	dq
待	d[uu
复	fnu
况	k]
楼	lle
丽	lme
痛	t/
梦	mce
呼	hui
摇	yh
期	qkei
英	yre
低	di
帝	dmoe
兄	xoi
背	be
背	bxi
持	cke
爷	yd
皇	h;u
七	qi
六	l/o
穿	cp
都	du
杨	y;ei
政	vce
运	yz
居	ju
叶	yxi
热	rx
校	jbei
校	xbe
谢	xx
曾	cfo
古	gj
细	xma
产	cg
睡	sc
希	xiuo
速	sne
室	smoo
旁	p;
另	lci
怀	hao
露	lne
异	yma
写	xdo
鬼	gf
娘	n;
取	qj
式	smea
除	cja
级	jkaa
考	kh
建	jva
愿	y]e
招	vye
饭	fv
布	bne
续	xn
程	cfu
首	slo
观	gpa
朋	pfu
务	wnu
掉	dbe
赶	gge
忽	huu
注	vno
术	snei
甚	sz
差	cq
差	c[
呵	heia
展	vg
争	vr
品	ps
兰	lgo
宝	bho
香	xpu
斗	d/o
故	gn
雷	ld
念	nv
段	d]u
顿	dz
角	jhu
角	jau
疑	yku
护	hn
闪	sg
木	mne
需	xu
调	dboa
调	tho
类	lxo
妹	mx
爸	b[
线	xva
左	zle
游	ylo
派	p[o
谈	tg
激	jio
冰	bro
敌	dku
跳	tb
支	vie
约	yqa
巴	bqa
您	ns
顾	gne
肯	ks
醒	xfei
铁	td
抱	bbe
淡	dvo
造	zb
伙	hlu
资	zi
群	qs
集	jkui
联	lgei
商	spo
号	hhi
号	hb
节	jde
讲	j;
掌	v;i
赵	vbe
密	mm
九	jlua
病	bco
卫	wxa
米	mk
威	wee
继	jma
渐	jvoo
统	tla
追	vru
亚	y[ei
简	jg
练	lv
基	jiei
选	x;u
推	tre
改	ga
退	tc
味	wxi
份	fz
举	jj
示	smee
忍	rs
历	lmeu
器	qmi
恐	kle
引	ysa
试	smoa
皮	pk
习	xka
靠	kb
导	dha
存	cse
莫	m/
志	vme
区	qu
汉	hv
右	y/e
严	yge
态	t[e
买	maa
幸	xce
社	sxo
佛	fl
佛	fju
议	ymoa
树	sneiu
止	vki
块	k[e
守	sloo
毛	mh
挥	hr
胡	hj
散	sge
散	sv
板	bg
仅	jsu
隐	ysai
怒	nn
床	c;o
苏	sue
料	lb
股	gju
局	jja
班	bte
图	tj
岁	sci
礼	lkoa
独	dj
初	cuo
福	fjo
顺	szu
狂	k;
默	m/i
巨	jne
既	jmae
松	soe
证	vco
烈	lxe
否	fle
恶	rd
恶	rxe
恶	wne
治	vmo
缓	h;a
排	pa
费	fx
拍	pq
耳	rke
医	yie
寒	hg
哭	ku
温	ww
府	fjoe
担	dte
担	dve
称	cz
称	cr
称	cc
余	yju
钟	voue
泪	lxoo
烟	yt
仍	rf
具	jni
忘	w]o
恩	rw
毕	bme
警	jf
蓝	lgeii
宫	goo
吸	xii
陆	lna
究	jo
抓	vq
压	yqe
沙	sqo
救	j/
呆	dqi
河	hdo
迷	mko
枪	qp
组	zja
权	q;e
叹	tv
孙	swa
卷	j;o
查	cae
毫	hho
春	cw
察	cao
圣	sca
草	che
较	jbea
胜	scu
遇	yni
充	coo
史	ski
堂	t;i
防	f;a
据	jnei
猛	mfua
骑	qka
土	tje
卡	ka
助	vni
京	jroe
银	ysu
贵	gci
永	yloa
质	vmuu
屋	wu
须	xuu
副	fne
换	h]
刺	cme
属	sja
闻	wso
境	jcei
禁	jwe
禁	jze
阴	ywa
共	g/e
负	fnua
弄	n/
翻	ft
虎	hji
层	cfa
喊	hgi
逃	thu
晓	xhi
座	z/o
雅	ya
参	ct
射	sxu
婚	hw
险	xga
君	jwa
划	h[e
坚	jti
价	j[
柔	rla
超	cy
扬	y;eie
科	ke
按	rve
狠	hsu
野	ydi
秦	qse
秘	mmu
熟	sloe
熟	sjo
置	vmi
仙	xtu
模	mle
模	mje
伸	swu
波	bo
肉	r/i
假	jaui
假	j[u
齐	qko
舞	wju
脱	tou
广	g;o
姑	gu
麻	mao
投	tle
顶	dfe
致	vmea
责	zde
景	jfi
营	yfe
维	wda
设	sxoa
坏	h[ei
啦	lqi
秀	x/
败	b[i
眉	mda
州	voo
药	ybe
承	cfai
案	rvo
狼	l;u
专	vpe
偷	toui
画	h[eia
吴	wji
店	dvoe
哦	r/ia
弹	dva
弹	tga
食	skuo
欲	ynu
抬	tae
标	bye
秋	qo
厉	lmeue
良	l;o
际	jmai
状	v]o
烦	fgo
午	wjue
摆	baei
戏	xmao
桌	voi
船	c;uu
短	d;
村	cwe
某	mlei
摸	mo
付	fnui
演	ygoo
规	gr
萧	xye
封	fre
握	w/
田	tgi
唐	t;o
藏	c;ei
震	vze
混	hso
混	hz
虚	xui
透	t/u
纪	jmaa
凌	lfo
休	xou
嘛	mqi
梅	mde
紫	zki
歌	gee
临	lsi
毒	dje
宗	zo
著	vne
索	sle
印	yzu
寻	xs
湖	hjo
劲	jzao
职	vkeii
技	jme
恨	hzo
婆	pl
杰	jdei
羽	yja
咱	zg
素	snee
凡	fgu
值	vku
飘	py
养	y;o
嘿	heiae
普	pj
宁	nfo
宁	nc
吓	x[i
兽	s/ou
夏	x[e
读	djo
街	jeu
牛	nl
仿	f;u
胸	xoua
浪	l]oo
富	fno
尚	s]i
宇	yjoo
骨	gji
智	vmue
纷	fwa
升	sru
叔	sui
善	svo
弱	r/a
架	j[a
卖	m[
袋	d[ui
网	w;i
朱	vu
骂	m[i
雄	xl
赛	s[
略	l[
杯	bee
施	sio
墙	q;ei
环	h;ee
罪	zci
牙	yae
窗	cpo
柳	llei
厅	treu
搞	gh
端	dpo
洞	d/oo
适	smue
拥	yo
释	smuo
洋	y;oo
肩	jto
魂	hse
闹	nb
蒙	mr
蒙	mfe
蒙	mfei
洗	xko
灯	dr
借	jxu
伯	bl
免	mgu
菜	c[e
验	yv
凤	fc
鱼	yjua
徐	xju
型	xfee
娜	n[a
娜	nla
暴	bbi
亡	w;o
讨	thoa
辈	bxie
懂	dl
腿	tfu
灭	mxe
妙	mb
效	xbo
危	weu
优	you
盘	pgu
套	tbe
丁	dre
趣	qn
妖	yya
束	sneia
杂	za
诗	sioa
迎	yfu
舍	sdu
旧	j/i
彩	cau
委	wdu
挂	g[e
笔	bku
狗	glu
鲜	xtua
鲜	xgu
纸	vka
抗	k]e
探	tve
韩	hge
尼	nk
控	k/e
惜	xkoo
珠	vue
抽	coe
创	cpu
创	c]
归	gri
挺	tfe
奋	fze
陪	pd
硬	yce
避	bma
园	y;ia
托	toe
训	xzo
勇	yla
聊	lhe
种	v/ue
奶	naa
庄	vpoeu
奔	bw
奔	bz
镇	vzu
拳	q;o
采	cauo
研	ygeu
将	j]
配	px
介	jxuo
尊	zw
冒	mbi
虑	lni
敬	jceii
丹	dtu
舒	suu
蛋	dvai
哼	hri
宋	s/oo
济	jmoo
妇	fna
箭	jvue
择	va
择	zdei
犯	fvu
欣	xwu
甲	jai
欧	ro
课	kxoa
扑	pu
菲	fee
菲	fd
燕	yve
曲	qui
曲	qji
躲	dlu
玄	x;o
幻	h]a
茶	caei
折	vde
折	sde
伊	yiui
傻	sa
姓	xca
源	y;ooe
洛	l/oo
遍	bvoa
臣	csei
弃	qmo
犹	ylu
占	vt
占	vvi
漂	pyo
漂	pho
漂	pb
挑	ty
挑	the
获	h/ei
绿	lnaa
峰	fri
俊	jzui
疯	fro
列	lxeu
作	zou
森	swe
妻	qie
恋	lvo
误	wno
拜	b[u
伟	wdui
移	ykue
纳	n[aa
党	d;i
罢	b[ia
腰	yyu
巧	qh
孤	gua
闭	bmo
圆	y;iae
碰	pc
镜	jcu
软	r;
厚	h/eu
累	ldi
累	lxi
昨	zli
幽	yoi
悲	bei
丈	v]e
牌	pau
降	j]a
降	x;a
颜	ygoe
劳	lhei
偏	pt
省	sfi
省	xfi
糊	hjou
糊	hno
馆	g;u
烧	sy
谓	wxo
财	cai
舰	jvuu
汗	hgo
汗	hvo
奈	n[e
操	cye
迹	jmoe
尸	siae
悄	qho
残	cge
尖	jtiu
鲁	lj
锋	fru
圈	j]i
圈	qpi
油	yloo
俩	lau
项	x]ei
撞	v]ei
瞬	szi
忆	ymoo
盖	g[o
尤	yleu
徒	tju
乡	xpa
概	g[ei
户	hnoa
荡	d]e
艺	yme
增	zr
祖	zjo
困	kz
殿	dvae
迅	xza
横	hfe
横	hce
范	fve
律	lnu
番	ftu
企	qku
惨	cgo
限	xvai
聚	jneii
含	hgu
凭	pfui
剧	jna
碎	sce
躺	t;u
缘	y;aa
凉	l;oe
腾	tfua
织	via
抢	qpe
抢	q;eie
预	yna
沈	sso
替	tm
孔	kla
批	pi
康	kp
惑	h/ea
唯	wdia
率	lno
惯	g]
登	dra
互	hne
盯	dri
稍	syu
宣	xpo
唱	c]i
诚	cfoa
剩	scue
咬	yhi
育	yno
诸	vuo
触	cnu
晨	csi
策	cx
疼	tfo
漫	mvoo
材	caeiu
补	bj
私	siue
吐	tji
吐	tn
纯	csaa
艾	r[e
贝	bxia
谷	gjuo
庭	tfoe
挡	d;e
晃	h;i
晃	h]i
吉	jkei
吹	cri
仔	zau
仇	clu
凝	nfoe
鼓	gje
农	nlo
席	xkoe
征	vruu
帅	s[i
附	fnai
缺	qq
塞	sqoo
塞	s[o
塞	sxoo
豪	hhoe
亦	ymoe
杜	dne
努	nja
判	pvo
谋	mlo
胆	dgu
尘	csiu
扎	vqe
滚	gs
闷	mwo
闷	mz
迟	cka
稳	wsu
翼	ymao
诺	n/o
闲	xgo
灰	hre
朵	dlua
盛	cfeu
盛	sceu
梁	l;oo
晶	jria
餐	cti
好	hba
爆	bbo
伦	lsu
娇	jya
侧	cxu
愣	lco
鼻	bkui
轮	lse
昏	hwu
抖	dle
陷	xvaiu
敏	msu
词	cko
慌	hpo
愤	fzo
怜	lgoo
颤	cv
阶	jea
苍	cpe
距	jnia
郑	vcou
川	cpui
扫	she
扫	sbe
逼	bi
县	xvi
忧	yoo
童	tlo
执	vkeie
丢	doue
荣	rle
臂	bmae
逐	vje
傲	rb
戴	d[ei
芒	m;e
庆	qc
伴	bvu
袭	xke
供	gou
供	g/ui
积	jiu
测	cxo
遥	yhu
阻	zjai
例	lmui
睁	vri
岛	dhu
遗	yki
瞪	dci
慕	mnei
皱	v/ua
博	ble
幕	mneii
猜	cqu
益	ymou
净	jco
泽	zdo
炼	lvou
监	jtii
鸡	jia
珍	vwe
伏	fjui
绍	sba
曹	chei
爬	pauu
丫	yqo
炸	vao
炸	v[
壁	bmaeu
涌	ylooe
凶	xouo
郎	l;oa
宿	snoo
宿	xlo
宿	x/o
怨	y]u
醉	zce
拼	pw
迫	p/u
革	gdei
瞧	qhi
奥	rbu
输	suea
莉	lmei
忠	voia
颗	kei
嗯	rwi
佳	jqu
旅	ljo
仁	rsu
鸟	nhu
骗	pva
浩	hbo
塔	taei
胖	p]
绪	xna
枫	frei
拔	baeie
赞	zv
炮	pbo
傅	fnuie
凯	kai
邪	xde
芳	fpe
浑	hsoo
夺	dleu
宽	kpo
堆	drei
裂	lxeua
遭	zy
赤	cmei
旋	x;oe
旋	x]o
扭	nle
洁	jdo
浮	fjoo
悉	xiuou
难	nva
擦	cqe
慧	hcee
典	dgi
赏	s;
匆	cou
评	pfo
纵	z/a
莲	lgeii
雾	wneo
乌	wuu
跃	y[i
壮	v]oe
贴	te
丰	free
隔	gda
健	jvuia
辛	xwoe
抵	dke
竹	vju
彻	cxuu
摩	mloe
轰	ho
编	bta
肚	dju
肚	dnu
插	cqei
磨	mloeu
磨	m/o
哎	rqi
御	ynuu
耐	n[eu
惧	jno
氏	smua
辉	hrio
扶	fje
恢	hro
貌	mbu
额	rdo
述	sneiu
票	pbe
录	lnae
拖	toei
膀	b;
膀	p;u
鹰	yro
孟	mca
递	dmou
瑞	rc
唇	cseu
暂	zve
货	h/ui
琴	qsee
踪	zoi
码	mae
慰	wxae
蛇	sdi
玲	lfe
晕	ywi
晕	yzi
损	sse
轩	xpe
粗	cuou
掩	ygei
屁	pm
悠	youi
仰	y;u
零	lfeo
盟	mfi
途	tjuo
贼	zdi
洪	hloo
悟	wnoo
固	gni
讶	y[o
冬	doua
滑	haoo
甜	tgu
郁	yne
琳	lsee
辆	l]e
乃	naau
猪	vuu
暖	n;i
妮	ni
挣	vre
挣	vcei
旦	dvia
估	guu
坦	tge
甘	gte
佩	pxu
莱	lae
享	x;oei
吼	hli
构	g/ei
粉	fs
萨	s[e
吻	wsi
潜	qgo
瓶	pfou
偶	rlu
戒	jxe
浓	nloo
毁	hfu
销	xyu
迪	dki
拒	jneie
绕	rba
勒	lxei
勒	le
朗	l;oae
嘻	xiia
尾	wdae
尾	ykae
帐	v]i
废	fxo
延	ygu
敲	qy
烂	lvouu
曼	mvi
厌	yveu
宜	yko
羞	xoo
喂	wxia
吟	ysi
滴	dio
洲	vooo
爹	deu
艳	yvee
晴	qfi
抚	fjei
缩	soaa
协	xdei
央	yp
悔	hfo
肖	xyi
肖	xbi
缠	cga
脆	ccu
痕	hsoe
伍	wjui
寂	jmooa
启	qkoa
翔	x;ou
薄	bhe
薄	blei
薄	b/
侯	hlui
劝	q]
郭	gooe
奴	njau
鸣	mfia
倾	qru
彼	bkuu
扔	rr
撒	sqe
撒	sae
豫	ynao
检	jge
针	vwu
耀	ybi
痴	cio
姆	mja
篇	ptu
椅	yke
厂	c;eu
董	dlei
熊	xla
埋	maei
乖	gqu
狐	hju
蒋	j;e
踏	t[i
隆	lla
括	k/ei
潮	cho
唉	r[i
穷	qlo
聪	coei
唤	h]ia
泰	t[ee
版	bgu
末	m/e
旗	qkoe
仪	ykui
焦	jyu
猫	my
盗	dboe
侍	smui
挤	jkeie
款	k;e
拾	skei
荒	hpe
强	q;ae
姿	zio
域	ynei
搭	dqe
脉	m[u
脉	m/u
授	s/e
俗	sju
融	rlei
狱	ynua
欺	qiei
访	f;o
桥	qhe
锁	slue
霸	b[e
牵	qte
池	ckoo
钻	zp
钻	z]
港	g;oo
喃	ngia
廷	tfue
乘	cfue
玛	maee
奉	fce
扯	cd
岳	y[ui
减	jgo
弯	wt
夹	jae
辞	cku
岸	rvi
岂	qki
屈	qua
恼	nho
哲	vdei
季	jmu
召	vba
丧	spe
丧	s]e
尝	c;io
恭	goeii
载	zae
载	z[e
瘦	s/oe
皆	jee
颇	po
茫	m;ei
染	rgo
肃	sna
爽	s;e
亏	kr
吞	tw
惹	rde
哀	rqo
乔	qhu
趁	cze
铺	puu
铺	pn
脏	zpu
吕	lji
奖	j;oe
倍	bxui
汤	tp
振	vzei
婷	tfa
牢	lho
扰	rh
溜	lo
溜	l/ooe
庞	p;o
臭	c/u
悦	y[oo
赫	hx
赢	yfo
跪	gcia
麦	m[e
枝	viei
侠	xau
泉	q;u
劫	jdeie
炎	ygou
泥	nko
赌	dji
弓	goa
魏	wxue
罩	vbi
疾	jko
饰	smuaa
符	fjue
垂	cfuei
映	yci
漠	m/oo
脖	blu
饮	ysua
沿	ygooe
懒	lgooi
肤	fuu
桑	spa
堪	kte
燃	rgou
卓	vli
祝	vnoa
赖	l[e
宾	bwo
贾	jaei
喘	c;ia
焰	yvo
吵	chi
冥	mfo
鞋	xdeii
逸	ymu
均	jwei
库	kn
裤	kno
碗	wgeu
航	h;uu
踢	ti
姨	ykau
酸	spei
啸	xbia
龄	lfi
阁	gdo
舌	sdue
箱	xpue
冯	ff
邦	bpe
钢	gpu
霞	xaeo
促	cnui
泡	pboo
盾	dzu
羊	y;ou
碧	bmee
援	y;eie
忌	jmaea
结	jeaa
抹	mleie
抹	m/ei
倩	qv
锐	rcu
喷	pwi
拦	lgeie
嘉	jqe
袖	x/oa
殊	sueu
辰	cseue
繁	fgue
络	l/a
抛	pye
嫁	j[au
咒	v/i
撤	cxe
键	jvuee
湿	sioo
恰	q[o
虫	cli
审	ssoo
献	xve
媚	mxa
贤	xgi
葛	gdeii
刹	squ
刹	c[u
袁	y;eie
摔	sqei
序	xno
筑	vnu
斜	xdu
瓦	wa
涂	tjo
湾	wto
莎	sqeii
崇	clia
猎	lxu
刑	xfeeu
墨	m/ia
娃	waa
梯	tie
桃	thei
豆	d/e
驾	j[aui
浅	qgoo
径	jcuu
饿	rxu
疲	pko
搬	btei
瓜	gquu
莹	yfei
滋	zioo
润	rzoo
铃	lfue
蛮	mgo
蒂	dme
拨	boe
涛	tyo
予	yjao
勾	goua
惠	hcei
析	xie
落	l[ei
落	lbe
砍	kg
撑	cre
截	jdeie
措	c/e
币	bmu
薇	weei
愈	ynuo
督	dui
酷	kne
祥	x;oa
怖	bno
侵	qwu
岩	ygi
扮	bve
糟	zyo
盈	yfa
腹	fnuae
斩	vge
尺	ckae
签	qtu
稀	xiue
掏	tye
夸	kqe
汽	qmoo
液	yxoo
姬	jiau
愧	kc
汇	hco
柱	vnei
粮	l;ou
堡	bhui
仗	v]ui
笨	bzu
奏	z/e
歉	qvo
甩	sau
怔	vcoo
允	ysao
竞	jcoe
祸	h/o
耶	ye
耶	yde
爵	jauo
绩	jmaae
诱	y/o
呜	wui
穴	xao
黎	lku
租	zu
培	pde
砸	zaeu
井	jfe
窝	wo
弥	mka
返	fguu
匹	pke
啥	sai
凑	c/o
奸	jta
陌	m/a
叛	pvou
核	hde
核	hje
卧	w/e
幅	fji
眨	vai
耗	hbe
洒	sao
怡	ykoo
详	x;oao
卢	ljie
扣	k/eie
哇	wq
丑	cla
勉	mgua
孝	xbei
矛	mha
氛	fwu
衡	hfuu
陶	tha
购	g/i
汪	wp
僵	jpu
疗	lhoe
妃	fea
罚	fai
系	jmua
棋	qkeiu
缝	ffa
缝	fca
咐	fni
躯	quu
泛	fvo
愁	clue
血	x[ui
搜	soei
慈	ckou
肥	fdu
笼	llue
篮	lgu
俱	jnu
惟	wdo
柜	gce
捉	voe
悬	x;i
霍	h/eo
泄	xxo
咽	yti
咽	yvi
齿	cki
秒	mhu
勤	qsei
扩	k/eie
屏	bf
屏	pfa
霜	speo
袍	phoa
蝶	ddi
祭	jmuao
夫	fjee
厨	cjeu
胁	xdua
璃	lkee
劈	pia
赚	v]ia
锦	jsue
尬	g[eu
尴	gteu
熙	xiei
寺	smeie
昌	cpi
贺	hxa
巾	jwi
描	mhe
捕	bje
陵	lfai
咳	kd
扇	sto
扇	svoa
虹	hlia
绵	mga
撕	siei
蔡	c[ei
催	cru
彭	pfe
宠	clo
贪	ttu
辱	rje
誓	smeie
盒	hduoe
寸	czei
披	pie
搂	loe
搂	lleie
饶	rhu
跌	dei
欠	qvu
肌	jiua
售	s/u
巡	xsa
抑	ymei
纹	wsa
宏	hlooa
幼	y/a
萍	pfei
驻	vna
丛	cluo
亿	ymui
播	boei
俄	rdu
刃	rza
蕾	lde
挨	rqe
仲	v/ui
迈	m[ea
违	wde
辩	bvoe
埃	rqei
艘	sou
琪	qkee
灾	zq
僧	srui
渡	dno
卑	beu
雕	dyu
鼠	sjui
讯	xzoa
辣	l[o
刷	sqa
艰	jtao
斥	cmu
裙	qso
翠	cca
饱	bhua
掠	l[eie
询	xso
勃	bleio
夕	xku
矮	ra
瑶	yhe
赐	cmi
捏	nee
闯	c;oi
姚	yha
瑟	sxe
渴	kdo
谅	l]oa
昂	r;i
串	c]ia
沟	gooo
涉	sxooe
咕	gui
驶	skaa
摄	sxei
贫	psu
辕	y;ea
婉	wga
答	dqu
鹏	pfua
姜	jpou
碍	r[eu
荷	hdei
荷	hxe
冠	gpoa
冠	g]o
魅	mxu
玫	mdee
裁	caeie
坡	poe
鸿	hlooe
邓	dcao
歪	wqe
乏	fau
申	swi
割	geo
巫	wue
衫	stoa
棒	b]
阔	k/o
泣	qmooe
韦	wdee
恍	h;o
贯	g]a
魄	p/ui
柄	bfe
患	h]iae
覆	fnei
蜜	mmo
婴	yri
励	lmeue
锅	goue
陛	bmai
遮	ve
帕	p[i
咖	gqi
咖	kqi
嫌	xgau
胳	geu
挖	wqei
啪	pqi
矿	k]eu
凄	qio
爪	vhu
爪	vau
眠	mgi
穆	mnu
啡	feia
吾	wjei
坛	tgei
脾	pku
恒	hfoo
屠	tja
玻	boee
蓉	rleii
础	cjeui
曰	yqi
耸	sluo
膊	blua
逆	nm
寿	s/ee
驱	quaa
猴	hlua
佣	y/ui
毅	ymoeo
舅	j/u
铜	tlu
娟	jpa
眯	mki
淫	yso
吩	fwi
匪	fde
牧	mnue
役	ymuu
寄	jmooa
诡	gfo
纤	xta
腐	fjoeu
姻	ywau
晰	xiiae
渊	ypo
亭	tfoeo
邀	yyui
哄	hoi
哄	hliae
骚	sya
墓	mneii
柯	kee
筋	jwue
崔	cria
灿	cvo
捷	jdeie
淋	lso
弗	fja
辑	jkea
棍	gz
绳	sfaa
喝	hxi
频	psi
廊	l;oeu
畏	wxiae
歇	xei
裹	glo
苗	mhei
盼	pvi
咯	gei
咯	loi
咯	l/i
耍	saeu
煞	s[u
寝	qsoo
瞒	mgia
添	tto
嫂	sha
纠	joa
慨	kao
嚷	r;ia
驰	ckaa
拐	gae
宴	yvoo
津	jwo
岚	lgi
浴	ynoo
耻	ckei
挽	wgei
页	yxe
誉	ynoou
牲	srue
乳	rju
仓	cpuo
逝	smeie
喉	hliae
逛	g]u
樱	yrei
兼	jtou
戈	geea
哗	hqia
哗	hai
会	k[u
涯	yao
捧	pfeie
铭	mfue
障	v]a
摊	tte
跨	k[i
妥	tluo
揉	rleie
晋	jzei
寞	m/ooa
寨	v[o
漆	qioo
污	wuo
嘲	chia
枚	mdei
吊	dbi
乾	qge
馨	xwe
伪	wduio
嗓	s;i
呈	cfi
卿	qrua
楠	ngei
籍	jkue
裸	lloa
链	lvu
灌	g]oo
昆	kw
畅	c]iae
逍	xyio
帽	mbia
阅	y[oi
逗	d/eo
蹲	dw
踩	caia
窜	c]o
哑	yai
趴	pqia
逢	ffu
植	vkeiu
媒	mdau
韵	yzo
昭	vyi
尹	ysae
谦	qto
档	d]ei
趟	tpe
趟	t]
沾	vto
兔	tnu
订	dcoa
朴	pje
瞎	xq
鞭	bteii
俺	rgu
斤	jwuu
翅	cmeia
肠	c;ua
雀	qyi
雀	qhiu
雀	q[i
慎	szo
盆	psuo
迁	qtue
镖	byu
芬	fwe
崖	yaia
丘	qou
蠢	csee
庙	mbo
潘	pto
颖	yfua
拓	t/e
娶	qje
纱	sqaa
漏	l/ooe
谨	jso
珊	ste
和	hxu
仆	pju
曾	zro
宙	v/o
尉	ynae
屑	xxa
叮	dria
捂	wjeie
涩	sxooe
诧	c[o
柴	caie
杆	gtei
杆	ggei
涵	hgoo
坠	vca
赔	pdi
涨	v;o
涨	v]oo
嘟	duia
崩	bri
薛	xqe
藤	tfei
税	scuei
枯	kue
译	ymoaa
帘	lgooa
糖	t;ou
愉	yjooi
骄	jyaa
羡	xvo
糕	gyo
彬	bwe
愚	yji
疏	sua
翰	hve
堵	djei
腕	wvu
眸	mli
芸	yse
溪	xio
殷	ywu
谎	h;oa
鼎	dfi
稿	ghu
哟	yoia
冤	ypoa
症	vro
症	vcoe
棵	keei
狄	dkua
咧	ldia
湘	xpoo
宛	wgo
嫩	nz
肆	smeie
宰	zao
憾	hvoo
偿	c;ui
腔	qpu
哩	li
豹	bbu
瑰	gre
鉴	jvi
绑	b;a
潇	xyo
戚	qieu
郡	jzae
澡	zho
桂	gcei
兮	xiuoe
雯	wse
颠	dtei
狮	siua
邻	lsuo
契	qme
骇	h[a
卜	boi
卜	bji
差	cqo
揭	jeei
妄	w]oe
坑	kre
伐	faui
矩	jju
烁	s/ouu
葬	z]e
诀	jaoa
鄙	bki
鹿	lnoe
柏	baeiu
柏	bleiu
溃	kco
朕	vzua
舟	vouu
妆	vpoei
躁	zbi
霉	mdeo
侦	vwui
冻	d/oe
娅	y[a
庸	yooe
筹	clueo
削	xyiou
削	xqi
砰	pr
耿	gfe
牺	xiuei
筒	tlue
遂	sco
旭	xnu
胎	tqu
惶	h;oo
淑	suo
叉	cqa
痒	y;oe
竖	sni
龟	gru
斑	btee
儒	rjui
嫣	yta
宅	vaoo
押	yqei
胃	wxiae
旨	vkua
册	cxua
膝	xiua
浸	jzo
弦	xgae
栏	lgeiu
衷	vooe
刮	gque
艇	tfuu
岗	g;i
赴	fneie
囊	n;e
斧	fjuo
颊	jaeo
疆	jpae
炉	ljou
塌	tqe
乞	qkue
旺	w]i
烤	kho
黛	d[uie
逊	xzai
贱	jvia
辨	bvoeo
狸	lkua
叙	xnuo
愕	rxo
叠	dda
遣	qgi
晌	s;ia
麟	lsoe
腥	xru
粒	lmou
拟	nke
俏	qb
杖	v]eiu
芝	vieii
夷	ykea
衬	czo
佐	zlu
巷	x]eii
捡	jgei
遵	zwo
塑	snou
桶	tlei
泼	poo
滩	ttoo
琼	qlee
昊	hbi
帆	fti
搏	bleie
颈	jfa
噢	roi
蹦	bci
寡	gao
贞	vwi
凰	h;ua
哨	sbi
拆	cqeie
茹	rjei
劣	lxiu
嘱	vji
沃	w/o
厢	xpeu
摘	vqei
咋	v[i
咋	zai
咋	zdia
坤	kwe
俯	fjuio
媳	xkau
赋	fnia
嘶	siia
贡	g/eie
碌	lneu
匙	ckia
拢	lleie
谭	tgo
翁	wr
辜	gue
竭	jdoe
廉	lgoe
械	xxe
贸	mbua
辅	fjea
讽	ffo
呐	n[i
斌	bwoe
辽	lha
填	tgeie
窃	qxo
抄	cyei
溢	ymooe
妒	dna
吁	xuia
吁	ynia
嗦	soi
掀	xte
芙	fjeii
祈	qkoai
栋	d/ei
吱	viia
撇	pe
撇	pdei
胞	byua
轿	jbeai
禅	cgoa
禅	svoai
妨	f;au
拂	fjeie
倦	j]u
衰	sqoe
靖	jcoeo
循	xsu
挪	nlei
蓬	pfeii
惩	cfuu
垃	lqe
账	v]iau
驳	bla
署	sji
甫	fjeia
顽	wgee
姥	lhau
圾	jieie
熬	rhe
枕	vse
丐	g[eie
茜	qve
咦	ykia
厕	cxeu
攀	pte
彤	tlua
妍	yga
拽	v[e
荆	jre
妓	jmau
壶	hjei
寇	k/oo
鹤	hxo
钥	ybu
骤	v/a
渺	mho
刊	ktee
肢	viua
烛	vjo
孕	yza
绽	vva
彦	yvoe
棉	mge
俘	fjuiu
盔	kreu
剪	jgou
诞	dvoa
兜	doui
凛	lsoeo
岭	lfia
嚣	xyia
溅	jvooe
笛	dkue
舱	cpuu
罕	hgoa
鸭	yqia
债	v[u
噬	smia
钉	dru
钉	dcu
躬	goui
倚	ykuie
缕	lja
咚	doi
撼	hvei
蕊	rfe
侄	vkui
佑	y/uie
雁	yveuu
隶	lma
践	jviae
拱	gle
沐	mno
菊	jje
蜂	fria
裕	ynoa
兆	vbu
搅	jhe
尿	nba
黯	rvia
歹	daeu
蓄	xne
朦	mfuae
嘀	dkia
怯	qxoo
叨	dyi
纽	nlaa
聘	pz
腻	nmu
剥	boa
彪	byi
沸	fxoo
氓	mfoe
卷	j]o
榜	b;e
榜	b]e
榜	pce
逻	llia
壳	kde
壳	qbe
储	cju
憋	beo
啤	pki
匠	j]e
悍	hvooi
昧	mxi
泊	blo
泊	pooo
篷	pfue
烫	t]o
狡	jhua
轨	gfea
汹	xooo
携	xdeie
磊	ldeu
隙	xmai
仑	lsuou
摧	crei
瞄	mhi
胧	llua
趋	que
挠	nhe
煌	h;ou
擅	sve
卒	cno
卒	zjoe
饼	bfu
狭	xaua
丸	wgu
惫	bxua
瞅	cliae
卡	qa
犬	q;eu
砖	vpeu
矣	ykao
楞	lce
昔	xieii
裳	spi
裳	c;iou
骆	l/aa
雇	gno
阎	ygoi
骷	kui
鸦	yqea
妞	no
墅	snia
焚	fse
谱	pjo
属	vja
绘	hca
梳	suei
肿	vlu
魁	kf
耽	dteii
擒	qseie
陡	dla
璋	vpee
茂	mbe
蹄	tkia
瞥	peo
瞳	tlia
髅	lliaa
绣	x/a
硕	s/eu
肺	fxu
参	cwa
参	swao
参	sta
兹	ziou
炒	chou
邮	yli
弘	hlae
嫉	jkaue
届	jxa
嗡	wri
把	b[ei
娱	yjau
喧	xpi
脂	viuae
膛	t;ua
沧	cpoo
疚	j/o
盐	ygeie
扁	bgo
扁	ptoa
搁	geei
茅	mheii
滔	tyoo
坟	fsei
掐	qqe
瑜	yjee
邱	qoui
桐	tleiu
茵	ywe
苹	pfeii
旷	k]i
翘	qbea
郝	hhe
蓦	m/eii
诈	v[oa
沫	m/ooe
菁	jrei
粹	cco
琢	vle
腊	l[u
钦	qwue
喻	yniae
宪	xvoo
锻	d]ue
睹	djia
郊	jyoe
饥	jiuaa
侃	kgu
粘	vtou
媛	y;au
谊	ymoao
恳	ksa
厮	sieu
锤	cfuee
凳	dcaou
淮	haooe
蔽	bmei
聂	nxe
贩	fvi
潭	tgoo
翩	ptoae
呻	swia
枉	w;e
拘	jue
煮	vjei
焉	yte
址	vkeie
匕	bkua
渗	szoo
览	lgii
敦	dwo
厦	s[eu
蕴	yze
冉	rgi
薪	xwei
呃	rxi
峻	jzi
荐	jve
栽	zqe
嚎	hhia
汁	vio
傍	b]u
秃	tuu
磕	keeu
禀	bfo
珑	llee
坎	kge
邵	sbau
萌	mfeii
窄	vaooa
阮	r;a
蹈	dhi
碑	beeu
婶	ssa
煤	mdo
寓	ynooa
栈	vve
滞	vmoo
倘	t;ui
杭	h;ei
暇	xai
藏	z]ei
狈	bxuau
峡	xaia
侣	lju
芦	lje
蔓	mve
蒸	vrei
禄	lnoa
胀	v]ua
醋	cne
淌	t;oo
伞	sgu
姊	zka
钩	gouee
衍	yguu
妾	qxoe
嘎	gai
蜀	sjia
蝴	hjia
萝	lleii
莽	m;eii
弩	njaue
祷	dho
稚	vmuei
圳	vzeie
徽	hru
衙	yau
咸	xge
陋	l/ai
奢	se
罐	g]ue
霄	xyeo
毙	bmea
汝	rjo
敞	c;iou
暮	mneii
嘘	xuiae
灼	vlo
澜	lgooe
姗	stau
倪	nku
挫	c/ei
咪	mi
钧	jwuee
捣	dhe
燥	zbo
泳	ylooe
眶	k]ia
乙	ykaa
澈	cxoo
焕	h]o
酬	cle
筷	k[ue
宵	xyoo
揪	joe
缚	fnaa
蚁	ykiae
喇	lai
丞	cfaia
拎	lw
吓	hxia
棠	t;io
咙	lliae
梭	soeiu
哧	cii
棺	gpe
璇	x;e
瀚	hvooe
肝	gtu
敛	lguo
剂	jmoeu
疤	bqo
渔	yjooe
嗔	cwi
沮	jjo
廖	lbo
虏	ljiea
皓	hbu
勋	xwi
恕	snau
虐	n[ie
虞	yjie
综	zoa
瘾	ysoe
驴	ljaa
晒	s[ia
卦	g[eie
迦	jqau
陀	tlai
窥	kro
堕	d/a
哆	doia
葡	pjei
帖	tdi
垫	dvei
屡	ljae
鹅	rdue
蛛	vui
盲	m;o
碟	dde
狞	nfu
囚	qli
诊	vso
揽	lgeie
裴	pdie
捞	ly
吏	lmeia
铮	vrue
萄	theii
盏	vgee
霆	tfeo
喔	woi
贷	d[uie
给	jkaae
勿	wnua
吭	kri
淘	thoo
辟	bmaeu
辟	pma
蔑	mxei
淹	yto
麒	qkoeu
喽	loia
栗	lmeia
绷	bra
惚	huo
桓	h;eiu
坊	fpei
桩	vpei
嗽	s/i
履	ljaeu
璐	lnee
菩	pjeii
巢	cha
畜	cnoe
畜	xnoe
兀	wneu
樊	fge
锡	xiuee
棚	pfeiu
仕	smuie
倏	suui
芹	qseii
僻	pmu
絮	xnau
杏	xcei
浆	jpoe
浆	j]oe
啧	zdiae
瘫	ttoe
磁	ckeu
冈	gpia
逮	daa
逮	d[a
搓	coeie
赠	zcia
胶	jyua
脊	jkoe
噩	rxei
绰	c/a
呕	rli
嚼	jhi
嚼	jaia
谐	xdoa
舍	sxuo
歼	jte
揣	cqeie
揣	caeie
殖	vkeu
拧	nfe
伺	cmui
伺	smuia
霖	lseo
驼	tlaa
襄	xpoe
衔	xguu
惕	tmo
掷	vmei
卸	xxu
炽	cmo
敖	rhee
惭	cgoo
框	k]ei
捆	kse
眩	x]i
蝉	cgi
谜	mkoa
炫	x]ou
塘	t;e
阱	jfai
膜	mlu
亨	hroe
奕	ymoeu
蚂	mai
蚂	m[ia
猩	xrua
滨	bwoo
沁	qz
跋	bai
藩	fte
舔	tgue
捐	jpe
歧	qkie
隋	sfai
蹭	cci
甄	vwei
蜡	l[i
嗤	ciia
缸	gpue
嬉	xia
哮	xyiae
熄	xiou
窍	qbo
俞	yjuo
豁	haooa
豁	hoo
豁	h/oo
垒	lda
掘	jaeie
琦	qkeei
屎	skae
乍	v[ue
孽	nxei
毯	tguee
弧	hja
槐	hae
铠	kau
挟	xdeie
襟	jwoa
梨	lkue
嗅	x/i
祁	qkoai
纲	gpaa
渠	qjo
矢	skue
捅	tleie
扛	k;ei
朽	xle
忖	cso
匈	xouau
扒	bqe
扒	pae
雍	yooea
莺	yreii
侮	wjuiu
闺	gro
霓	nkeo
斋	vqo
稽	jiue
夭	yyue
沦	lsoo
揍	z/ei
瞟	phi
苟	glei
琉	lleei
漪	yioo
暑	sjiae
窟	kuo
钓	dbue
鳞	lsua
瓷	ckoe
萱	xpei
株	vuei
倭	wou
鞘	qbei
沛	pxo
噜	lu
绞	jha
颓	tfuei
睿	rci
噗	pui
唔	wjia
幢	v]iai
喀	kqia
诅	zjoa
涕	tmoo
拣	jgeie
谣	yho
叽	jii
葱	coeii
拭	smeie
婢	bmau
铸	vnue
绮	qkaa
剿	jhaa
胤	yzua
秩	vmuei
畔	pvia
粥	voae
奎	kfe
绸	claa
茨	ckeii
觉	jbo
熏	xwue
蹬	dcia
诏	vbo
岔	c[uo
叭	bqi
咆	phia
滥	lvoo
梧	wjeiu
垮	kae
澳	rbo
浙	vx
甸	dvu
绯	feaa
诛	vuoa
鲍	bbua
刁	dya
厥	jaeu
蚊	wsia
鞠	juei
歆	xwoeo
拙	voei
茗	mfeii
眷	j]ou
戮	lnao
唬	hjiae
骏	jzaa
扳	bteie
踹	c[i
漓	lkoo
蝇	yfi
擂	lxeie
涡	woo
沌	dzo
凸	tui
蚩	cia
酿	n]
唾	t/i
琐	slee
犀	xiae
澄	dcoo
澄	cfoo
哉	zqei
猾	haua
煎	jtoue
窒	vmooa
虾	xqia
蝠	fjia
钞	cyu
瓣	bvoeo
唧	jiia
觑	qni
哽	gfi
娥	rda
婿	xnaue
讪	svoai
耕	gree
葫	hjeii
暧	r[ia
浇	jyoo
嗨	hqiae
诵	s/oa
疫	ymoeu
兢	jreii
箫	xyue
颅	ljiea
啼	tkiae
绅	swaa
杉	stei
嗜	smiae
券	q]o
遁	dzuu
炯	jlo
霎	s[eo
讥	jioa
迭	ddue
彷	p;uu
觅	mmuo
娴	xgaue
抿	mse
剔	tii
稻	dbuei
敷	fue
泻	xxoo
怠	d[ao
龚	goeu
绒	rlaa
讳	hcoa
勺	shu
函	hga
喳	cqi
颂	s/uo
搀	cte
撩	lye
擎	qfe
巍	wei
脯	fjua
脯	pjua
镶	xpuee
寥	lhoo
漾	y]o
缴	jhaae
藉	jkeii
藉	jxei
弊	bmou
逞	cfia
膏	gyoe
戳	coa
呛	q]i
凹	ry
叩	k/i
禽	qsu
懊	rboo
懈	xxooi
蛟	jyi
亢	k]o
呸	pei
芊	qtei
慑	sxooi
跺	d/i
跄	q]ia
蚀	skua
栖	qieiu
蔚	wxei
铲	cgu
坪	pfeie
筝	vrueo
顷	qfea
腮	squa
别	bxiae
踉	l]i
划	haea
当	d]i
狰	vrua
踱	dli
嗖	soia
苑	y]ei
秉	bfue
猿	y;ua
堤	die
佟	tlui
悯	mso
唠	lhi
唠	lbi
憨	ht
肘	vlua
拇	mjei
僚	lhu
霹	pieo
婕	jdau
禹	yjui
啃	ksi
匀	ysuao
颤	vvoe
晖	hria
怅	c]oo
聋	lleu
拯	vfe
忿	fzu
韧	rze
邹	zoua
梢	sye
肋	lxua
窘	jloo
嵌	qvi
婪	lgeiu
辖	xaea
浦	pjoo
炭	tvi
曦	xiiae
簇	cnue
螺	lliae
酱	j]oei
屯	ts
悴	ccoo
匡	kpe
冀	jmi
倔	jauia
橙	cfei
陕	sga
筱	xhu
叱	cmia
髓	sfia
淳	csoo
矜	jwao
詹	vtu
菱	lfei
芷	vkeii
惺	xroo
浊	vloo
囔	np
朔	s/oue
憔	qhoo
睫	jdi
睬	caiae
鸽	geuo
臀	tsa
吨	dwi
笙	srueo
戟	jkeii
沼	vho
谍	ddo
昕	xwia
蛊	gjia
煜	ynou
祀	smoai
罡	gpiai
伶	lfui
荫	ywei
荫	yzei
酥	sueia
懦	n/oo
厄	rxeu
峨	rdi
轴	vlea
伽	jqui
雳	lmeo
卵	l;ua
捶	cfeie
檐	ygeiu
棘	jkeia
嗣	smiae
钗	cque
袜	w[o
妩	wja
炕	k]ou
偎	weui
窦	d/ooa
蝎	xeia
溶	rlo
膨	pfuae
峙	vmia
缉	jiaa
徊	hauu
呗	beia
衅	xzu
砂	sqeu
舵	d/u
昼	v/ae
迸	bcou
斟	vweii
舆	yjuie
椒	jye
靓	l]ee
旬	xsua
厘	lkeu
窑	yhoo
萎	wdei
涟	lgooe
疙	geoe
瘩	dqo
瘩	dao
梵	fvei
靴	xqei
侥	jhui
匿	nme
挚	vmeie
镯	vlue
兑	dcou
尧	yhea
徘	pauui
芽	yaei
狙	juu
闵	msoi
辫	bvoeo
瀑	pno
更	grei
嗷	rhi
庐	ljoe
芯	xweii
禾	hdue
澎	pfoo
邢	xfeeu
绊	bvaa
蜘	viiae
憎	zroo
靡	mkoe
靡	mkoeu
褚	vjoa
湛	vvoo
蒲	pjeii
嚓	cqia
珂	keee
崽	zaia
贬	bgi
惮	dvoo
婵	cgau
嗒	t[ia
悸	jmooi
晦	hci
涅	nxo
恬	tgooi
慷	kpoo
穹	qloo
渣	vqoo
屉	tma
缭	lhaa
绢	j]aa
袱	fjoa
黝	ylia
袅	nhua
淇	qkoo
茄	jqei
茄	qde
寅	ysoo
赦	sxeie
祟	scai
榻	t[ei
蛙	wqi
苇	wdeii
嵩	soiai
茉	m/eii
咏	yliae
凿	zhi
粪	fzou
噪	zbia
菌	jweii
蝙	bti
庶	snoe
邸	dkuae
禧	xkoa
攒	zge
旱	hvi
虔	qgie
榴	lleiu
琛	cwee
漱	snooe
忑	txe
匣	xaeai
忐	tgie
谬	m/oa
蟒	m;i
棱	lfeiu
钝	dzue
悚	slooi
廓	k/oe
惘	w;oo
漉	lnoo
蟹	xxua
佬	lhui
曳	yxia
赎	sjiau
壤	r;e
忡	cooo
倡	c]u
冶	ydo
竿	gtue
蜷	q;i
癌	rao
嘈	chiae
蚕	cgee
剖	pooe
颁	btuo
缀	c/aa
汀	tro
谕	ynoau
牡	mju
斐	fdi
懵	mfoo
分	fzuo
斗	dlo
皙	xieiu
缪	mba
缪	mla
蔷	q;eii
诫	jxo
恤	xnoo
咄	doiae
馒	mguaa
矫	jhue
矫	jhuee
痞	pkoe
橘	jjei
氧	y;ue
贿	hcia
肮	rp
瑾	jse
烙	lbou
璧	bmaeu
攘	r;ei
攥	z]eie
肖	xbio
汰	t[o
溺	nmo
铅	qtuee
咔	kaia
芭	bqei
戎	rlea
褐	hxoa
巩	gleie
吆	yyi
彰	vpoeo
漩	x;oo
聆	lfeii
蒜	s]ei
棕	zoe
鹃	jpi
帜	vmiai
鄂	rxia
搐	cnei
蔼	rae
怦	pro
穗	scuei
亩	mjo
撰	v]eie
绎	ymaa
牟	mlao
咨	zioe
奄	yteu
梓	zke
亲	qco
绚	x]a
阀	fao
烘	hoou
炙	vmua
翎	lfuo
惋	wgoo
驯	xzaa
栩	xje
逾	yjuoe
墟	xue
鬟	h;eie
茬	caeii
褪	tco
鑫	xwuo
骸	haia
峭	qbi
缅	mgaa
灶	zbou
洽	q[oo
祯	vwo
暄	xpia
裔	ymoeu
韶	sho
缎	d]a
砚	yveui
锥	vruee
辙	vdea
惦	dvooi
铛	crue
枣	zhe
桦	h[eiu
邃	scoo
橱	cjei
搔	syei
腑	fjuae
解	xxuau
萤	yfeii
枢	sueiu
遏	rxiae
募	mneii
憬	jfo
庵	rto
叼	dyia
嫖	pha
苛	keeii
锣	lluee
蹑	nxi
拌	bvei
奠	dvou
秽	hcu
殴	roe
喋	ddia
糙	cyo
貂	dyuo
揖	yiei
葵	kfei
榆	yjeiu
颐	ykei
皂	zbu
眈	dti
扼	rxeie
眺	tbi
孜	zia
簌	snu
玺	xkua
偌	r/u
蹿	cpia
蓓	bxe
弛	ckaea
庇	bmoe
檀	tgeiu
枭	xyua
螂	l;ia
趾	vkia
崭	vgi
妲	daau
掂	dteie
醇	cseia
掺	ctei
驿	ymaae
槽	cheiu
惬	qxooi
镰	lgue
抡	lwe
憧	coooi
删	stu
鸳	ypu
酣	hte
宦	h]oo
筐	kpu
琅	l;e
瞻	vti
飙	byeu
湃	p[oo
俨	ygui
跷	qyia
栅	v[ei
栅	steiu
撅	jqeie
煽	stou
呱	guia
缰	jpaa
猝	cnua
衮	gso
肴	yhuo
殆	d[eu
谴	qgoa
蔬	sueii
飒	s[oe
说	scoa
婧	jca
阐	cgoi
荧	yfeii
侈	ckui
霏	feeo
瘟	wwo
芜	wjeii
俭	jgu
崎	qkia
亥	h[oe
俐	lmuiu
屿	yjia
譬	pmae
饺	jhuaa
垄	lleua
畴	cliae
杠	g]e
鬓	bze
讼	s/oau
晏	yvia
弈	ymoeu
鞍	rte
瘸	qao
钮	nlu
珏	jaee
钰	ynue
傀	kfu
噔	driae
驭	ynaa
靶	baeii
萦	yfeii
韬	tyee
恙	y]ou
懿	ymeie
竺	vjue
吝	lzo
羁	jiiai
荀	xse
癫	dto
嘭	pri
菇	guei
恃	smooi
儡	ldu
瘪	beoe
瘪	bdo
踌	cliae
呦	yoiae
榕	rleiu
昵	nmi
躇	cji
烬	jzou
啰	loiae
酌	vlei
丙	bfei
涎	xgoo
哒	dqia
冽	lxoe
砌	qmeu
鸾	l;oei
烨	yxou
翟	vaa
翟	dka
辗	ngea
噎	yei
驹	jua
噼	pii
咎	j/ua
亵	xxoe
陨	ysaii
蠕	rji
冕	mgiae
雌	ckie
茸	rleii
瑛	yree
剃	tmou
掰	bque
蹙	cneu
橡	x]eiu
佯	y;ui
笃	djue
崛	jaiai
勘	ktei
稼	j[ue
桀	jdu
渝	yjooe
汐	xioo
锈	x/u
磅	b]eu
壕	hhei
娄	llou
撮	coeie
撮	zlei
玑	jiee
祠	ckoa
娲	wqa
鹫	j/oe
黏	ngu
珀	p/e
睽	kfi
栓	speiu
绫	lfaa
阑	lgoi
邑	ymia
瑕	xaee
磋	coeu
粟	sneia
薯	sje
沪	hnoo
讷	nxoa
岑	csia
炜	wdou
玮	wdeei
娼	cpa
迂	yu
伎	jmui
鲸	jru
翡	fdie
坝	b[eie
铐	kbu
洼	wqo
蹊	xiiae
寐	mxo
肾	szii
鸯	ypi
敝	bmoui
涧	jvooe
崆	koi
甭	bfeu
笠	lmue
扈	hnoae
哝	nli
芮	rce
卉	hceie
靳	jzeii
诬	wuoa
札	vae
婊	bha
裘	qlei
扉	feo
疮	cpoe
巅	dtia
坞	wnei
膳	svu
鳄	rxua
捺	n[ei
悼	dboo
茧	jgeii
毋	wjaa
曙	sjiae
馅	xvu
簸	blue
簸	b/u
忒	tee
奇	jieu
叟	slui
拴	speie
嬷	mqau
稣	suua
痹	bmoeu
垣	y;eie
蛤	gdi
蛤	haiae
谏	jvoa
羹	grou
沥	lmoo
蛾	rdia
瑚	hjee
熔	rlou
惆	cloo
雏	cjua
饷	x;ua
拗	rbe
拗	n/e
燎	lhou
熠	ymouu
薰	xweii
蕃	fgei
捋	ljei
籁	l[ue
髦	mheie
飓	jnua
簿	blueo
簿	bnu
迢	thau
闸	vaoi
狩	s/ua
鲨	sqooe
蜥	xiiae
惴	vcooi
胯	k[ua
侨	qhui
劭	sbaui
烹	proe
咣	gpiae
攸	youii
锄	cjue
硝	xyeu
颔	hvu
鸥	roea
滕	tfuae
寰	h;ooa
紊	wsoe
蕉	jyei
稠	cluei
蟆	maia
垢	g/eie
楷	kaei
炊	cro
忻	xwoo
炳	bfou
腆	tgua
褒	byo
酋	qlou
赃	zpi
拈	nt
拈	ngeie
抒	sueie
孰	sjoe
袄	rho
褂	g[oa
孺	rja
胭	ytu
赘	vcee
嫡	dkau
礁	jyeu
啜	c/i
钳	qgue
晾	l]ia
茎	jreii
隧	scaio
窿	lloo
骋	cfaa
嫦	c;a
掳	ljeie
槛	kgei
莞	g;e
莞	wgeii
瓢	phe
曜	ybia
锯	jnue
猖	cpua
遐	xaa
蹋	t[iae
飕	soua
渍	zmoo
麾	hroeu
猥	wdua
篝	goueo
殉	xze
枷	jqeiu
蜒	ygia
皎	jhuia
霁	jmeo
诩	xjo
窖	jboo
咫	vkae
檬	mfeiu
乒	pru
奚	xiuoo
淤	yuo
父	fjuou
溯	snooe
凋	dyo
纺	f;aa
篱	lkueo
泌	mmoo
刨	bbuaa
刨	phu
樵	qhei
忏	cvoo
盎	r]i
戾	lmoa
阿	re
咀	jji
屹	ymiai
冲	c/oe
挎	k[ei
羔	gyou
殃	ype
庚	groe
淼	mhia
淀	dvooe
隘	r[a
绛	j]aae
缨	yra
璨	cve
跤	jyia
锵	qpue
摁	rzei
痊	q;oe
嫔	psa
臻	vwea
泯	msoo
糜	mdoe
睦	mni
喵	myi
缥	pya
褥	rno
魇	ygeue
汶	wzo
馋	cgua
渎	djoo
蜿	wti
抠	koe
诶	reo
墩	dwe
棣	dmei
沓	t[iau
喏	rdiae
诲	hcoau
琶	paee
缈	mhaa
缔	dma
酝	yzeia
耷	dqeu
弼	bmaea
柬	jgeia
浏	llooe
拷	khe
剁	d/ua
柿	smeiu
琵	pkee
沂	ykooe
捻	ngeie
帛	blui
柠	nfei
饵	rkuaa
撂	lbei
娓	wdau
乓	pp
轲	keea
髯	rge
娉	pra
尽	jsa
圭	greie
璀	cfee
苔	tqei
苔	taeii
肪	f;ua
吮	ssi
瞩	vjia
啄	vlia
帷	wdiai
箍	guue
蟑	vpi
炖	dzou
梗	gfei
捎	syeie
嗬	heiae
蘑	mleii
唏	xiiae
鹊	q[ei
矶	jieui
羌	qpo
骼	gdia
筛	sque
鲤	lkuai
羲	xioue
祺	qkoai
馈	kcu
伫	vnui
羿	ymaoe
苞	byei
犁	lkuei
啬	sxeio
舷	xguua
矗	cneii
癖	pkoeu
掣	cxue
匾	bge
瀛	yfoo
谧	mmoa
珞	l/e
毓	ynuea
衲	n[o
恺	kaoo
纬	wdaa
惰	d/ooi
嘤	yria
诣	ymoau
谛	dmoa
藻	zhei
啷	lp
佘	sduo
黠	xaiao
饲	smuaa
虬	qlia
涤	dko
骡	llaa
钵	bou
邯	hgei
笋	ssue
芥	jxeii
醺	xweia
佼	jhuio
舜	szuo
龌	w/i
簪	zt
痰	tgoe
论	lsoa
蹂	rlia
恻	cxooi
簧	h;ue
甥	sruee
腼	mguae
单	cgou
单	svou
驮	tlaae
缤	bwa
潺	cgooe
獠	lhua
筏	faue
锭	dcue
阙	qqo
阙	q[oi
粤	y[uia
瞌	keia
琏	lgee
龊	c/ie
椎	vreiu
唆	soiae
煦	xni
嵋	mdi
幡	ftia
翌	ymaoe
毡	vtue
碳	tveu
鸨	bhuae
闽	msoia
躏	lzi
蜓	tfi
咻	xoia
捍	hveie
睨	nmia
鼾	htu
桔	jjeiu
娆	rha
抉	jaeie
蜻	qri
徨	h;uui
嗲	dai
碾	ngeu
哐	kpi
粼	lsou
啐	ccia
谑	x[o
嚏	tmi
鳖	beou
榨	v[eiu
倜	tmu
稷	jmue
篡	c]ue
晤	wni
肇	vboa
咂	zqi
帚	vla
瘤	lloeu
瞠	criae
嚅	rjia
怆	c]ooi
撵	ngeie
裆	dpoa
腺	xvua
骁	xya
坷	kdei
螃	p;i
冢	vloa
锢	gnu
濒	bwooe
蝗	h;ia
烽	frou
莘	swei
辘	lnea
撬	qbeie
瓮	wc
亘	gze
钊	vyu
篓	llueo
缇	tka
宸	csooa
胄	v/ia
鞑	daei
羚	lfou
绥	sfaae
笺	jtu
荤	hwe
迄	qmu
踞	jniae
桨	j;oei
慵	yooo
噤	jzia
幌	h;iai
跚	stia
袒	tgoa
浣	h]ooe
榄	lgeiu
痪	h]oe
荼	tjei
阉	ytoi
腋	yxu
骰	tliaa
曝	pni
涮	s]o
踵	vliae
炬	jnou
涣	h]ooe
俟	smuia
皑	rau
瞑	mfiae
渲	x]oo
擞	slei
赂	lnia
湮	ytoo
麓	lnei
铿	kru
埔	pjeie
峦	l;oei
涓	jpoo
掬	jueie
怏	y]oo
莓	mdeii
萃	cce
呲	zii
蹒	pgi
鳌	rheei
睐	l[ia
昱	yniae
和	hjue
和	h/ue
旌	jroea
摞	l/ei
吠	fxi
濮	pjooe
谙	rtoa
啕	thi
轶	ymea
搪	t;ei
陇	llai
纨	wgaa
膺	yroe
皋	gyu
霭	raeo
呓	ymiae
橄	ggeiu
纶	lsa
垛	d/eie
嗫	nxia
盅	voiae
踝	haiae
臧	zpe
淅	xiooe
岌	jki
岱	d[uie
璞	pjee
缄	jtaa
秧	ypue
翱	rhui
卤	ljiei
逅	h/uu
靥	yxeu
磐	pguu
壑	hxie
斓	lgoeu
翊	ymoeo
挛	l;oei
叁	stao
佗	tluio
阖	hdoi
怂	sluou
戬	jgeii
汲	jkoo
垠	ysei
迥	jli
咛	nfi
邂	xxuau
杞	qkeiu
痘	d/oeu
臊	sbu
藕	rleii
媲	pmau
湄	mdoo
癞	l[oe
辄	vdeai
獒	rheei
恪	kxoo
砾	lmeui
痉	jcoeu
蜕	tci
椰	yee
差	ciou
仨	squi
纣	v/aa
馁	nd
蜈	wjiae
镐	ghue
窈	yhooa
秤	ccue
粱	l;ooe
辐	fjeai
悖	bxo
涔	csooe
偕	xdui
渭	wxoo
汴	bvoo
蜴	ymiae
桅	wdeiu
隅	yjai
卯	mhua
骜	rbee
孚	fjuoo
禺	yjiae
琥	hjeei
杵	cjeiu
掖	yeei
畸	jiiae
晔	yxiae
婀	rea
菡	hveii
噶	gaia
昙	tgia
坍	ttei
俑	ylui
滤	lnooe
侏	vuui
潦	lhooe
挲	soo
硫	lleui
俸	fcu
蟠	pgia
弋	ymeao
梆	bpei
驸	fnaae
笈	jkueo
忱	csooi
恿	ylao
龟	jwua
胥	xua
垦	ksae
窕	thooa
滇	dtoo
珅	swee
圃	pji
咿	yii
徙	xkuu
瘴	v]oeu
舫	f;uu
嗝	gdiae
泞	nco
藐	mheii
赣	gvo
鹦	yriau
逵	kfeie
戍	sneu
榭	xxei
揩	kqei
熹	xieie
蟾	cgia
霾	maeo
蔫	nte
跛	bli
岐	qkiai
脐	qkua
糗	qloue
螳	t;ia
哺	bjia
鹭	lniae
蚣	goi
嵬	wdiai
褶	vdo
恸	t/o
隽	j]ui
玥	y[ee
籽	zko
釜	fjuou
剐	gaiae
鸠	jou
磷	lseu
娑	sooo
巳	sma
谄	cgoau
恣	zmoe
猬	wxua
酪	lbeia
丕	pieu
溟	mfooe
隼	ssui
芋	yneii
觊	jmia
筵	ygue
娣	dmau
盹	ds
涸	hdoo
劾	hdoe
颌	hduoe
殇	speu
轧	y[ea
沽	guo
愫	snooi
鸢	ypea
玷	dvee
掸	dge
溥	pjooe
疵	cioe
皖	wgui
杳	yhei
镀	dnue
祎	yioa
鹉	wjeea
匍	pjuae
崴	wai
岖	quia
幔	mvia
蝈	goia
镑	b]ue
臆	ymua
偃	yguie
蜗	woia
瞰	kvi
侬	nlui
郸	dtou
缆	lga
袂	mxoa
诠	q;oa
犊	djuei
摹	mleii
蟀	s[iae
邋	lqa
竣	jzoe
骥	jmaae
泗	smooe
痣	vmoe
贲	bwei
胴	d/uae
潼	tloo
弑	smuoe
匐	fjuae
姣	jyau
谤	b]o
蘸	vvei
蟋	xiiae
渥	w/oo
浒	hjoo
蛐	quiae
阂	hdoia
糯	n/ou
愠	yzoo
嵇	jiuei
谒	yxoa
舀	yhuoo
否	pkeu
呤	lfiae
槟	bweiu
嘣	bria
脓	nlua
樟	vpeiu
忪	voooi
蛰	vdeie
咤	v[ia
阜	fnuia
峥	vria
濡	rjoo
遢	t[iae
担	dgei
瑙	nhee
碉	dye
孵	fuua
讹	rdoa
彝	ykaae
颀	qkuu
篆	v]ue
臾	yjuie
椭	tleiu
沏	qiooe
颦	psie
蛆	quiae
淆	xho
揄	yjeie
压	y[eu
嗑	kxi
踮	dgia
犷	g;ua
荔	lmeii
鳅	qoua
闫	ygoia
隗	wdai
渤	bloo
馍	mlua
锏	jgue
楣	mdeiu
蜃	sze
遛	l/u
查	vqeiu
倌	gpui
氤	ywue
戌	xueu
嶙	lsia
馗	kfua
匮	kce
揶	ydei
胚	peu
啻	cmoe
敕	cmeia
夙	snua
珈	jqee
锹	qyu
摒	bce
迩	rkuai
啾	joi
峪	yniai
菠	boeii
馥	fnue
槌	cfeiu
褛	ljoa
贻	ykiau
礴	bleu
豚	tsu
氲	ywuee
湍	tpo
腌	ytua
蚱	v[iae
殡	bzeu
毗	pkia
耙	paeee
诽	fdo
褴	lgoa
瘁	ccoe
蚌	b]i
铝	ljue
蔻	k/eii
憩	qmue
锚	mhue
濑	l[oo
耘	ysee
俾	bkuiu
鬃	zoei
裟	sqooe
苒	rgei
蘅	hfei
鱿	ylua
傥	t;uii
袈	jqaui
豺	cauoo
町	tfia
掇	doei
坯	piei
戛	jaeui
贮	vnia
塾	sjoei
剽	pyei
孬	ny
衩	caoa
镣	lbu
戊	wneua
犟	j]ae
酉	ylei
斡	w/ei
匝	zqea
诘	jdoa
攫	jaeie
潢	h;ooe
黔	qgia
臃	youa
罂	yriau
轼	smeai
酗	xnei
嘹	lhia
阪	bga
冗	rloa
桧	gceiu
皿	msi
囡	nti
辍	c/ea
觎	yjuoe
浚	jzoo
闰	rzoi
臼	j/ui
蹩	bdou
煲	byui
怵	cnoo
囤	tsi
罔	w;ia
蚓	ysia
碴	caeu
灸	jluao
蚯	qoi
嗥	hhiae
堑	qvea
箴	vwue
谗	cgoau
嵘	rliai
箩	llueo
碱	jgeu
葆	bhei
旎	nkoe
谆	vwoa
粽	z/ou
牒	ddui
泸	ljoo
刽	gcu
诋	dkoa
缜	vsa
爻	yhuou
贰	rme
坳	rbei
睑	jgi
葭	jqeii
妪	ynau
镂	l/ue
癸	gfa
笆	bqueo
壬	rsue
绉	v/aae
抨	pre
叵	ple
箕	jiueo
坨	tleie
颉	jdeie
姹	c[a
赳	joei
焊	hvou
淬	ccooe
纭	ysaa
埠	bnei
泱	ypoo
恹	ytooi
榛	vweiu
酵	jbeia
銮	l;oei
佶	jkuie
犒	kbue
茱	vueii
饪	rzu
孪	l;oei
砺	lmeui
遽	jnie
嗟	jei
钙	g[u
谚	yvoa
鲲	kwu
谟	mloa
馊	souaa
雉	vmuee
虱	siau
糠	kpou
赈	vzi
旮	gqua
骠	bya
峋	xsi
跆	tai
瘠	jkoeu
饕	tyi
佚	ymuiu
淄	ziooe
谀	yjoa
镳	byue
读	d/oa
廿	nve
喟	kci
偻	llui
绺	llaae
骨	guiaa
沱	tlooe
囱	coui
兖	ygoeu
袤	mboe
畿	jiaao
诌	vooa
苯	bse
佻	tyu
魈	xyui
屌	dhae
谲	jaoaa
泾	jroo
獗	jaua
蹶	jaiae
绔	kna
雹	bheo
旯	laia
洱	rko
馄	hsua
粲	cvi
哂	ssia
蔗	vxe
饨	tsua
奘	z]a
芍	shei
淞	soooe
腴	yjuae
剜	wtoo
汾	fso
顼	xuee
濂	lgooe
蜚	fdiee
殒	yseu
鹞	ybuo
蚤	zha
浃	jqo
坂	bgei
颚	rxiae
忤	wjo
眦	zmi
彗	hceee
暹	xti
赧	ngeie
佝	gouiu
钺	y[ue
嘞	lei
硅	greu
玳	d[ee
蛹	yliae
睾	gyui
盂	yjeei
赁	lzu
瑁	mbee
骛	wna
宕	d]o
纂	z;
堰	yvei
厩	j/e
萋	qieii
帔	pxi
杈	c[eiu
熨	yzae
挞	t[eie
觐	jzeii
煊	xpou
钏	c]uee
泫	x]ooe
迳	jcao
缮	sva
燧	scou
孱	cgae
懑	mzo
柩	j/ei
漕	choo
鹄	hjuei
龛	ktu
饯	jvua
餮	txeu
幄	w/ia
鹘	gjiaa
倨	jnui
诙	hroa
锃	zcu
颧	q;eii
纰	piaa
鏖	rhoe
氢	qrue
楔	xee
藜	lkeii
栀	vieiu
谥	smoao
骧	xpaa
犄	jiuei
葳	weeii
魑	ciu
聒	goeii
椿	cwei
伢	yaui
谩	mgoa
鹜	wnao
燕	ytei
闩	spoi
颍	yfuai
濠	hhoo
仞	rzui
鳗	mguai
踊	yliae
痿	wdoe
皈	grui
骊	lka
孑	jdai
帼	glia
撸	lue
檄	xkei
啵	boia
柚	y/ei
篑	kcue
陲	cfaiu
潋	lvooe
樽	zwe
遨	rheei
舶	bluu
莆	pjeii
蛀	vniae
抻	cweie
搽	caeie
俪	lmuie
铉	x]ue
嚯	h/i
茁	vleii
韭	jlie
膘	byuae
酩	mfeia
榔	l;ei
娩	mgau
汗	hvooe
刎	wsua
扪	msei
漳	vpoo
仃	drui
饬	cmua
壹	yieie
裨	bmoa
裨	pkoa
巽	xzae
黜	cni
滂	ppo
鹂	lkeia
徉	y;uu
戕	qpa
埂	gfeie
纫	rzaa
溉	g[oo
胛	jauae
锌	xwuee
遑	h;ui
跻	jiiae
蒿	hy
钛	t[u
岷	msia
葩	pqe
磺	h;eu
汕	svoo
肛	gpua
涿	voooe
鲛	jyuai
睥	bmi
滦	l;ooe
稔	rsuei
锲	qxu
徜	c;uui
冼	xgoe
獐	vpu
喙	hciae
讧	h/oa
氨	rtu
褓	bhoa
赊	sei
菀	wgeii
鄱	plu
炅	gciae
碜	cseui
戗	qpuo
瓴	lfuoo
酊	dfei
钠	n[u
镌	jpue
铀	ylue
羯	jdou
挝	woe
襁	q;oai
渚	vjoo
胫	jcua
雎	jui
砥	dkeu
衢	qju
狒	fxua
骞	qtoo
荟	hceii
华	haui
号	hbia
正	vreie
石	dveu
汛	xzoo
色	saua
盥	g]ui
睚	yaiae
栎	lmeiu
砣	tleu
烩	hcou
夯	hpeu
拮	jdeie
驷	smaa
殓	lve
哔	bmia
徇	xzuu
蹴	cnia
忾	k[o
疹	vsoe
鸵	tluao
韫	yzee
祛	quo
膻	stua
黢	quiao
仄	zx
唳	lmi
烊	y;ouu
烊	y]ouu
孀	spau
腚	dcua
牍	djui
佃	dvui
赡	svi
秣	m/ue
榷	q[eiu
镭	ldue
铄	s/ue
嫒	r[au
饽	boua
谌	csoa
啮	nxiae
蝼	lliae
闱	wdoi
篙	gyue
逡	qwa
膑	bzua
隍	h;ai
罄	qce
蕨	jaeii
呢	nki
囵	lsiae
橹	ljeiu
睢	sria
喱	lki
肓	hpoe
榈	ljeiu
绶	s/a
槊	s/oue
罹	lkia
槁	ghe
秸	jeue
裱	bhoai
牦	mhuei
滓	zkoo
腓	fdua
砝	fae
舐	smuei
谶	czoa
秆	ggu
荏	rse
斛	hjua
暨	jmaee
滟	yvooe
纾	suaa
粑	bqou
诳	k;o
寮	lhooa
鹑	csoe
驽	njaue
囫	hjiae
徕	lauu
弭	mkae
橇	qye
痢	lmoe
圜	h;iae
撺	cpei
柑	gteiu
儆	jfu
魉	l;ui
妊	rzau
氏	viuae
酶	mdeia
庖	phoe
缢	ymaae
俎	zju
鲫	jmuai
藓	xgei
佰	baui
痔	vmoeu
觥	gouau
哞	moi
伉	k]u
怄	r/o
轱	guea
泵	bceu
擀	ggeie
蝌	keiae
绌	cna
蓑	soeii
釉	y/uo
翳	ymeau
讫	qmoa
蜇	vee
蜇	vdeie
砧	vweu
殄	tgeu
萼	rxeii
胰	ykua
蜍	cjia
瘀	yuoe
鸪	gueii
霰	xveo
鹧	vxo
诨	hzoa
僭	jvuie
弁	bvao
湎	mgoo
栉	jdeiu
蹉	coi
醍	tkei
磬	qcei
泷	llooe
蓼	lheii
铂	bluee
梏	gnei
鸩	vzo
豌	wte
嘬	zoia
疡	y;oeu
荞	qheii
涝	lboo
蛔	hfi
焖	mzou
祉	vko
魍	w;ui
跎	tliae
锉	c/ue
桎	vmeiu
喆	vdeie
娠	swau
诿	wdoa
瓯	roeau
殚	dteu
镁	mdue
痂	jqoe
胱	gpuae
刍	cjuaa
醐	hjeia
糅	rloue
愎	bmoo
赝	yveuu
唁	yviae
笳	jque
崂	lhiai
踽	jjia
鳍	qkuai
帧	vwia
骈	pga
仟	qtui
羸	ldo
谪	vdoa
狲	swua
槃	pguua
珲	hree
蛭	vmiae
痍	ykoe
猢	hjuau
鼹	yguie
悌	tmooi
莅	lmeii
咩	mei
誊	tfou
鳝	svua
韪	wdiae
噱	jaiae
俚	lkui
硌	gxe
脍	k[uae
汞	gleie
淖	nbo
姘	pwa
聩	kcei
泅	qlooe
喑	ywia
绦	dkaa
铡	vaue
恽	yzooi
遒	qloue
痨	lhoeu
蚪	dlia
蒺	jkeii
觞	spua
葺	qmei
煅	d]ou
悱	fdoo
茕	qleii
靛	dveei
诓	kpoa
箔	blueo
珥	rkee
岬	jaiai
臬	nxu
肱	gouae
焙	bxou
鸷	vmeie
蜢	mfiae
莠	yleii
铨	q;ue
胺	rvu
堇	jsei
嶂	v]iai
钾	jaue
跹	xtia
鹌	rteu
笞	ciue
缛	rna
椽	c;eiu
苕	theii
酮	tleia
婺	wnaoa
貉	hduoo
囿	y/i
铣	xkue
舂	coee
碘	dgeu
馔	v]uaa
铢	vuue
涪	fjooe
氯	lnue
傣	daui
度	dloe
篾	mxue
猕	mku
砒	pieui
颛	vpia
柒	qiooe
饴	ykuaa
圩	wdeie
疱	pboe
圄	yjiae
枸	gleiu
貅	xouoo
蛎	lmia
唢	sli
窠	keo
囹	lfiae
撷	xdeie
伥	cpuiu
疟	n[oe
傩	nluia
诟	g/o
嗞	ziia
赅	gqia
楂	vqeiu
氮	dvue
竽	yjue
碣	jdeu
谔	rxoa
铧	haue
铆	mhuee
滁	cjo
遴	lsoue
舛	c;uao
荠	jmei
稞	keu
阄	joo
荚	jaeii
媪	rhau
悒	ymooi
笏	hnu
晷	gfia
宥	y/oo
豸	vmuo
摈	bzei
凫	fjuao
阡	qta
粕	p/o
癣	x;oeu
珐	f[e
馏	lluaa
龈	ysie
锒	l;ue
虻	mfiae
腩	ngua
吖	rqia
瓤	r;o
楫	jkeiu
镊	nxue
阆	l]oi
豕	skeua
擘	b/a
玎	dree
馐	xouaa
潍	wdoo
龅	byie
黩	djiao
芪	qkeii
砭	bteu
腱	jvuae
挈	qxe
怼	dcaoe
嬗	svau
貔	pkuo
杷	paei
讴	roo
铬	gxu
沆	h]ooe
蝮	fniae
烷	wgou
箜	kou
揿	qze
茴	hfeii
鲈	ljua
昴	mhiae
缟	gha
瘙	sbo
痫	xgoeu
矾	fgeu
氖	naue
烯	xiouu
铰	jhuee
妯	vlau
耄	mbei
搦	n/ei
飨	x;aa
鳏	gpuai
痼	gnoe
讣	fnoa
馕	n;u
鲇	nguai
妁	s/au
垩	rxeii
枇	pkei
幂	mmoai
蟊	mhao
萁	qkeii
鹳	g]ei
盱	xuiae
帑	t;a
侪	caui
娌	lkau
煸	bto
孳	zioue
蚋	rcia
脔	l;oei
箬	r/ue
樯	q;eiu
趸	dse
苣	jneii
萸	yjeii
謇	jgoo
妣	bka
啁	voiae
氰	qfu
蒹	jtei
莴	woei
夤	ysuao
鹬	ynaoa
腭	rxuae
鲑	grua
淦	gvoo
鲠	gfu
蚝	hhiae
瀣	xxooe
骐	qkaae
堀	kuei
柞	z/eiu
泔	gto
锰	mfuee
蟥	h;iae
薅	hye
嵯	cliai
蛳	siiae
篦	bmue
荜	bmeii
焯	cyou
芡	qvei
螯	rheei
眙	ykiae
肄	ymuau
荨	qgei
耋	ddei
俳	paui
铱	yiue
薮	sleii
笄	jiueo
渑	mgooe
豉	ckeia
疣	yloe
镍	nxuee
轳	ljea
熵	spou
瘆	szoe
杼	vneiu
诂	gjo
鲶	nguai
氟	fjuee
洄	hfooe
孢	byai
郴	cweiu
詈	lmiai
鞣	rleii
蜉	fjiae
耦	rlee
蛉	lfiae
箪	dtue
愆	qtuu
藿	h/eii
痱	fxoe
纡	yua
葚	szei
黧	lkuei
毖	bmeau
髋	kpia
坻	dkei
蜊	lkiae
铙	nhue
漯	t[oo
骟	svaa
捌	bqeie
椴	d]eiu
墒	speie
溘	kxooe
牖	yluie
蹚	tpi
阋	xmo
龋	qjie
刈	ymuo
悭	qtooi
蠲	jpoue
瓠	hneu
圪	geeie
轾	vmeai
麸	fuee
锱	ziu
瞽	gjei
糍	ckoue
蹼	pjia
鳕	xauai
偬	zlui
榫	ssei
秭	zku
瘢	btoe
殍	pheu
碇	dce
碓	dceu
孓	jaai
痧	sqoeu
痈	yooeu
埚	goeie
壅	yooea
怙	hnooi
癔	ymoeu
潆	yfooe
檩	lsei
痤	cloe
嘚	deia
菽	sueii
茭	jyeii
酰	xtei
菏	hdeii
诹	zoo
粳	jroue
糌	zto
舸	gdu
趵	bbia
枥	lmeiu
膈	gdua
傧	bwu
鸬	ljiea
艿	nae
酚	fwei
椟	djeiu
氦	h[ue
笸	plue
疸	dgo
醛	q;eia
篌	hlue
枳	vkeiu
酯	vkeia
髫	theie
缳	h;aa
孥	njaue
溧	lmooe
镬	h/uee
卺	jsai
皴	cwao
鍪	mlaoa
坩	gteie
砻	lleua
郯	tgou
筚	bmueo
跬	kfia
醚	mke
蚧	jxi
肽	t[ua
绀	gva
顸	htee
谵	vtoa
鲟	xsuai
屣	xkae
鹚	ckoue
焗	jjou
疖	jeo
炝	q]ou
啉	lsiae
硒	xieu
伛	yjuie
蛄	guiae
燹	xgeu
缫	syaa
髀	bmiaa
凇	sooe
鼙	pkeie
悛	qpoo
轫	rzea
苷	gteii
羝	diou
蘖	nxeii
蚍	pkiae
桡	rhei
耨	n/ee
搴	qtooa
榧	fdei
蚜	yaiae
轭	rxea
皲	jwoae
胝	viuae
蝣	yliae
鲋	fnuai
硼	pfeu
葸	xkeii
溏	t;ooe
鲱	feu
溽	rnoo
滏	fjooe
彖	t]a
耜	smeee
嫠	lkeei
锂	lkuee
劬	qjua
颟	mt
曈	tliae
濞	bmooe
郫	pkui
怍	z/oo
螨	mgiae
阈	ynoi
肫	vwua
蝰	kfiae
蝓	yjiae
暌	kfiae
蒌	lleii
颞	nxeii
鲷	dyua
囟	xzui
溴	x/oo
畚	bsa
癜	dvoeu
辊	gse
嘌	pyi
烃	trou
柽	creiu
秕	bkue
豇	jpeo
蛞	k/ia
颃	h;oe
骶	dkiaa
鳔	bbuai
髂	q[ia
瘘	l/oe
胗	vwuae
髌	bzi
楦	x]eiu
籼	xto
齁	hou
骒	kxa
堙	yweie
袪	quoa
酞	t[eia
鲻	ziua
氪	kxu
