去	q
起	q[
前	q]
我	w
为	w[
无	w]
他	t
她	t[
天	t]
一	y
有	y[
也	y]
是	s
说	s[
上	s]
人	r
然	r[
而	r]
的	d
得	d[
地	d]
在	f
自	f[
发	f]
个	g
过	g[
更	g]
会	h[
好	h
还	h]
将	j[
就	j
间	j]
可	k
看	k[
空	k]
了	l
来	l]
里	l[
下	x
心	x[
小	x]
成	c[
出	c
从	c]
这	v
中	v[
只	v]
不	b
把	b[
被	b]
你	n
能	n[
那	n]
没	m
吗	m[
明	m]
到	p
大	p[
都	p]
着	ve
们	mw
道	db
么	me
子	fk
时	sk
要	yb
后	h/
以	yk
和	hd
对	dx
想	x;
之	vi
手	sl
生	st
使	sku
身	sw
头	tl
样	yp
事	sm
多	do
己	jk
家	jq
面	mc
知	viu
开	kq
如	rj
现	xc
很	hs
点	df
经	jt
情	qg
老	lh
些	xe
话	hq
已	yka
又	y/
声	ste
意	ym
于	yj
回	hdi
笑	xb
所	slu
但	dc
眼	yf
方	fp
年	nf
见	jc
当	dp
女	nj
真	vw
两	l;
力	lm
气	qm
用	y/u
长	c;
长	v;
动	d/
国	gl
走	fl
让	rp
给	gd
正	vv
问	wz
打	da
儿	rk
法	fa
才	ca
几	jku
行	h;
行	xg
三	sr
定	dv
此	ck
进	jz
再	fq
种	vl
实	sko
同	tli
最	fx
本	bs
向	xp
分	fw
十	ske
学	xd
高	gy
第	dm
感	gf
怎	fs
神	ss
听	tt
边	br
作	f/
其	qk
吧	bq
却	qx
口	kl
觉	jd
啊	rq
因	yw
白	ba
次	cm
军	jw
做	f/u
外	wq
门	ms
光	gp
风	ft
主	vj
住	vn
果	gli
与	yje
全	qf
二	rm
候	h/u
公	go
相	xpe
相	xpei
等	dg
别	bd
色	sx
死	skeu
张	vp
部	bn
太	tq
日	rmi
少	sh
少	sb
战	vc
理	lk
直	vk
重	cl
重	v/
王	w;
像	xpu
脸	lf
比	bk
快	kqo
何	hdu
水	sd
名	mg
体	tk
呢	ne
东	doe
叫	jb
西	xi
应	yt
应	yv
便	bc
便	pf
放	fpo
马	ma
难	nfa
轻	qt
美	md
位	wx
关	gr
机	ji
接	je
先	xr
文	ws
处	cj
处	cn
并	bv
望	wp
常	c;i
完	wf
四	smi
飞	fe
师	si
者	vd
安	rr
清	qto
刚	gpi
跟	gw
月	yx
信	xz
山	sri
爱	rqu
内	nx
龙	ll
带	dq
找	vh
原	yfe
入	rn
李	lke
连	lfe
吃	ci
场	c;e
平	pg
思	sii
林	ls
变	bco
什	ssu
由	yl
受	s/
亲	qw
命	mv
目	mn
强	q;
男	nfi
任	rz
该	gq
路	ln
车	ce
今	jwu
海	ha
加	jqa
远	yfee
活	hl
特	tx
解	jdu
电	dci
世	sme
性	xv
表	bh
许	xj
它	tqo
立	lmo
黑	he
金	jwuo
红	hla
花	hqe
转	vf
转	vce
总	flo
算	sc
城	cg
队	dxa
孩	haa
反	ff
工	goe
始	ska
满	mf
新	xw
兵	bt
物	wn
离	lko
非	fei
虽	se
云	ys
似	smu
万	wc
至	vm
干	gre
干	gc
通	to
认	rzo
失	siu
火	hlo
哥	ge
士	smei
五	wj
惊	jto
魔	ml
竟	jv
姐	jda
乎	hu
剑	jcu
往	w;u
量	l;i
量	lp
早	fh
结	jdaa
着	vy
着	vho
着	vlo
怕	pq
流	llo
突	tu
坐	f/uo
斯	sie
音	ywo
紧	js
指	vke
拉	lq
杀	sq
半	bcou
记	jm
且	qd
利	lmu
合	hduo
倒	dh
倒	dbu
书	su
度	dn
微	we
步	bni
教	jy
教	jbe
喜	xk
越	yxe
影	yg
谁	sdo
冷	lg
深	swo
告	gb
落	l/
象	xpua
容	rl
怪	gqo
传	cf
传	vcu
钱	qfu
提	tke
言	yfo
随	sda
每	mdu
双	sp
服	fj
击	jie
武	wje
哪	na
数	sj
数	sn
站	vco
奇	qke
房	f;
管	gfu
灵	lga
刻	kx
题	tki
衣	yi
周	vo
静	jve
伤	spu
百	bae
拿	nau
妈	mq
办	bca
星	xt
化	hqu
功	goei
绝	jdaa
系	xm
般	bru
必	bm
业	yxi
尔	rku
件	jcui
血	xdu
血	xx
代	dqu
精	jtou
弟	dmo
终	voa
近	jzu
条	th
青	qte
界	jx
司	sia
整	vg
欢	hr
字	fm
晚	wfi
民	msa
帮	bp
切	qe
切	qxe
即	jka
忙	m;
交	jyo
或	h/e
暗	rc
夫	fu
员	yfi
根	gwe
石	skeu
哈	hqi
夜	yxo
父	fn
制	vmu
友	yle
阿	rqa
息	xiu
冲	co
酒	jl
保	bhu
片	pc
形	xge
阵	vz
南	nfe
决	jdo
请	qgo
各	gx
报	bb
兴	xto
兴	xvo
阳	y;
急	jkua
语	yjo
令	lv
错	c/
及	jkau
刘	lloe
极	jke
识	skoa
备	bx
慢	mco
雪	xde
苦	kj
若	r/
领	lgu
收	so
底	dk
尽	jza
准	vs
华	hau
华	hqui
答	dau
众	v/u
千	qr
要	yy
消	xy
视	smo
罗	lli
敢	gfa
留	llu
克	kxe
乐	lx
乐	yxu
够	g/
跑	ph
显	xf
嘴	fd
官	gro
断	dco
未	wxe
势	smei
句	jn
求	ql
计	jmo
论	lz
达	dae
则	fdi
害	hqo
八	bqu
单	dr
久	jlu
脚	jh
德	dd
元	yfee
脑	nh
楚	cje
雨	yjei
睛	jti
响	x;i
刀	dy
确	qxeu
玉	yn
沉	cs
北	bdi
格	gde
停	tg
陈	csa
市	smoe
朝	vye
朝	ch
喝	hei
族	fjo
江	jp
团	tf
母	mj
章	vpo
装	vpoe
亮	lpo
客	kxo
照	vb
乱	lc
易	ymi
足	fji
依	yiu
黄	h;e
修	xo
破	p/
台	ta
球	qle
呀	yq
院	yc
送	s/o
包	by
义	ymo
诉	sno
攻	goei
丝	siaa
围	wd
玩	wfe
待	dquu
待	dquu
复	fnu
况	kp
楼	lle
丽	lme
痛	t/
梦	mve
呼	hui
摇	yh
期	qkei
英	yte
低	di
帝	dmoe
兄	xoi
背	be
背	bxi
持	cke
爷	yd
皇	h;u
七	qi
六	l/o
穿	cr
杨	y;e
政	vve
运	yz
居	ju
叶	yxia
热	rx
校	jbei
校	xbe
谢	xxo
曾	cgo
古	gj
细	xma
产	cfo
睡	sxi
希	xiuo
速	sne
室	smoo
旁	p;
另	lvi
怀	hao
露	lne
异	yma
写	xdo
鬼	gdu
娘	n;
取	qj
式	smea
除	cja
级	jkaa
考	kh
建	jca
愿	yce
招	vyei
饭	fc
布	bne
续	xn
程	cgu
首	slo
观	gra
朋	pgu
务	wnu
掉	dbe
赶	gfe
忽	huu
注	vno
术	snei
甚	sz
差	cq
差	cqo
呵	heia
展	vfa
争	vt
品	ps
兰	lfo
宝	bho
香	xpue
斗	d/o
故	gn
雷	ld
念	nc
段	dcu
顿	dz
角	jhu
角	jdua
疑	yku
护	hn
闪	sf
木	mne
需	xu
调	dbo
调	tho
类	lxo
妹	mx
爸	bquo
线	xca
左	fle
游	ylo
派	pqo
谈	tfo
激	jio
冰	bto
敌	dku
跳	tb
支	vie
约	ye
巴	bqa
您	ns
顾	gne
肯	ks
醒	xgei
铁	td
抱	bbe
淡	dcoo
造	fb
伙	hlu
资	fi
群	qs
集	jkui
联	lfei
商	spo
号	hh
号	hb
节	jde
讲	j;
掌	v;i
赵	vbe
密	mm
九	jlua
病	bvo
卫	wxa
米	mk
威	wee
继	jma
渐	jco
统	tla
追	veu
亚	yqe
简	jf
练	lca
基	jiei
选	xfu
推	te
改	ga
退	txa
味	wxi
份	fz
举	jj
示	smee
忍	rs
历	lmeu
器	qmi
恐	kle
引	ysa
试	smoa
皮	pk
习	xka
靠	kb
导	dha
存	cse
莫	m/
志	vme
区	qu
汉	hc
右	y/e
严	yfei
态	tqe
买	maa
幸	xve
社	sxo
佛	flu
佛	fju
议	ymoa
树	snei
止	vki
块	kqe
守	sloo
毛	mh
挥	hee
胡	hj
散	sfe
散	sce
板	bf
仅	jsu
隐	ysai
怒	nn
床	c;o
苏	sue
料	lb
股	gju
局	jja
班	bre
图	tj
岁	sxia
礼	lkoa
独	dj
初	cu
福	fjoa
顺	szu
狂	k;
默	m/i
巨	jne
既	jmae
松	soe
证	vvo
烈	lxe
否	fleu
恶	rd
恶	rxe
恶	wne
治	vmo
缓	hf
排	pa
费	fxa
拍	pqe
耳	rke
医	yie
寒	hfo
哭	ku
温	ww
府	fjoe
担	dre
担	dce
称	cz
称	ct
称	cv
余	yju
钟	vou
泪	lxoo
烟	yr
仍	rg
具	jni
忘	wpo
恩	rw
毕	bme
警	jg
蓝	lfei
宫	goo
吸	xii
陆	lna
究	jo
抓	vq
压	yqeu
沙	sqo
救	j/
呆	dqi
河	hdo
迷	mko
枪	qp
组	fja
权	qfe
叹	tc
孙	swa
卷	jfo
查	cae
毫	hho
春	cw
察	cao
圣	sv
草	che
较	jbea
胜	svu
遇	yni
充	coo
史	ski
堂	t;
防	f;a
据	jnei
猛	mgu
骑	qka
土	tje
卡	ka
助	vni
京	jtoe
银	ysu
贵	gxi
永	yloa
质	vmuu
屋	wu
须	xuu
副	fne
换	hce
刺	cme
属	sja
闻	wso
境	jvei
禁	jwe
禁	jze
阴	ywa
共	g/e
负	fnua
弄	n/
翻	fr
虎	hji
层	cga
喊	hfi
逃	thu
晓	xh
座	f/o
雅	ya
参	cra
射	sxu
婚	hw
险	xfa
君	jwa
划	hqea
坚	jr
价	jqu
柔	rla
超	cy
扬	y;ei
科	ke
按	rce
狠	hsu
野	ydi
秦	qse
秘	mmu
熟	sloe
熟	sjo
置	vmi
仙	xru
模	mle
模	mje
伸	swu
波	bo
肉	r/i
假	ja
假	jqui
齐	qko
舞	wju
脱	tou
广	g;
姑	gu
麻	mao
投	tle
顶	dge
致	vmea
责	fde
景	jgi
营	yge
维	wda
设	sxoa
坏	hqei
啦	lqi
秀	x/
败	bqi
眉	mda
州	voo
药	ybe
承	cgai
案	rco
狼	l;u
专	vr
偷	toui
画	hqei
吴	wji
店	dcoe
哦	r/ia
弹	dca
弹	tfa
食	skuo
欲	ynu
抬	tae
标	bye
秋	qo
厉	lmeu
良	l;o
际	jmai
状	vpoe
烦	ffo
午	wjue
摆	baei
戏	xmao
桌	voi
船	cfu
短	dfu
村	cwe
某	mlei
摸	mo
付	fnui
演	yfoo
规	gee
萧	xye
封	fte
握	w/
田	tfi
唐	t;o
藏	c;ei
震	vze
混	hso
混	hz
虚	xui
透	t/u
纪	jmaa
凌	lgo
休	xou
嘛	mqi
梅	mde
紫	fki
歌	geei
临	lsi
毒	dje
宗	fo
著	vne
索	sle
印	yzu
寻	xs
湖	hjo
劲	jzao
职	vkei
技	jme
恨	hzo
婆	pl
杰	jdei
羽	yja
咱	ffi
素	snee
凡	ffu
值	vku
飘	py
养	y;o
嘿	heia
普	pj
宁	ng
宁	nv
吓	xq
兽	s/ou
夏	xqe
读	djo
街	jeu
牛	nl
仿	f;u
胸	xoua
浪	lpoo
富	fno
尚	spi
宇	yjoo
骨	gji
智	vmue
纷	fwa
升	stu
叔	sui
善	sco
弱	r/a
架	jqau
卖	mqe
袋	dqui
网	w;i
朱	vu
骂	mqia
雄	xl
赛	sqoo
略	lxi
杯	bee
施	sio
墙	q;e
环	hfe
罪	fxi
牙	yae
窗	cp
柳	llei
厅	tte
搞	gh
端	dro
洞	d/oo
适	smue
拥	yo
释	smuo
洋	y;oo
肩	jro
魂	hse
闹	nb
蒙	mt
蒙	mge
蒙	mgei
洗	xko
灯	dt
借	jxu
伯	bl
免	mfu
菜	cqe
验	yca
凤	fv
鱼	yjua
徐	xju
型	xgee
娜	nq
娜	nla
暴	bbi
亡	w;o
讨	thoa
辈	bxie
懂	dl
腿	tdu
灭	mxe
妙	mb
效	xbo
危	weu
优	you
盘	pfu
套	tbe
丁	dte
趣	qn
妖	yya
束	snei
杂	fau
诗	sioa
迎	ygu
舍	sdu
旧	j/i
彩	cau
委	wdu
挂	gqe
笔	bku
狗	glu
鲜	xrua
鲜	xfua
纸	vka
抗	kpe
探	tce
韩	hfei
尼	nk
控	k/
惜	xkoo
珠	vue
抽	coe
创	cpu
创	cpuo
归	gei
挺	tge
奋	fze
陪	pd
硬	yve
避	bma
园	yfia
托	toe
训	xzo
勇	yla
聊	lhe
种	v/ue
奶	naa
庄	vpoe
奔	bw
奔	bz
镇	vzu
拳	qfo
采	cauo
研	yfeu
配	px
介	jxuo
尊	fwo
冒	mbi
虑	lni
敬	jvei
丹	dru
舒	suu
蛋	dcai
哼	ht
宋	s/oo
济	jmoo
妇	fna
箭	jcue
择	va
择	fdei
犯	fcu
欣	xwu
甲	jai
欧	ro
课	kxoa
扑	pu
菲	fee
菲	fdei
燕	ycei
曲	qui
曲	qji
躲	dlu
玄	xfo
幻	hca
茶	caei
折	vde
折	sde
伊	yiui
傻	sa
姓	xva
源	yfoo
洛	l/oo
遍	bcoa
臣	csei
弃	qmo
犹	ylu
占	vri
占	vci
漂	pyo
漂	pho
漂	pb
挑	ty
挑	the
获	h/ei
绿	lnaa
峰	fti
俊	jzui
疯	fto
列	lxeu
作	fou
森	swe
妻	qie
恋	lco
误	wno
拜	bque
伟	wdui
移	ykue
纳	nqa
党	d;
罢	bqia
腰	yyu
巧	qh
孤	gua
闭	bmo
圆	yfia
碰	pv
镜	jvu
软	rf
厚	h/eu
累	ldi
累	lxia
昨	fli
幽	yoi
悲	bei
丈	vpe
牌	pau
降	jpa
降	x;a
颜	yfoe
劳	lhei
偏	pr
省	sg
省	xgi
糊	hjou
糊	hno
馆	gfua
烧	sy
谓	wxo
财	cai
舰	jcuu
汗	hfoo
汗	hco
奈	nqe
操	cye
迹	jmoe
尸	siae
悄	qho
残	cfe
尖	jri
鲁	lj
锋	ftu
圈	jci
圈	qri
油	yloo
俩	la
项	xpei
撞	vpei
瞬	szi
忆	ymoo
盖	gqou
尤	yleu
徒	tju
乡	xpa
概	gqei
户	hnoa
荡	dpe
艺	yme
增	ftei
祖	fjoa
困	kz
殿	dcae
迅	xza
横	hg
横	hv
范	fce
律	lnu
番	fru
企	qku
惨	cfoo
限	xcai
聚	jnei
含	hfu
凭	pgui
剧	jna
碎	sxe
躺	t;u
缘	yfa
凉	l;oe
腾	tgu
织	via
抢	qpe
抢	q;ei
预	yna
沈	sso
替	tm
孔	kla
批	pi
康	kpo
惑	h/ea
唯	wdi
率	lno
惯	gco
登	dta
互	hne
盯	dti
稍	syu
宣	xro
唱	cpi
诚	cgoa
剩	svue
咬	yhi
育	yno
诸	vuo
触	cnu
晨	csi
策	cx
疼	tgo
漫	mcoo
材	caei
补	bj
私	siue
吐	tji
吐	tn
纯	csaa
艾	rqe
贝	bxia
谷	gjuo
庭	tgoe
挡	d;e
晃	h;i
晃	hp
吉	jkei
吹	cei
仔	faui
仇	clu
凝	ngo
鼓	gje
农	nlo
席	xkoe
征	vtu
帅	sqi
附	fnai
缺	qeu
塞	sqoo
塞	sqoo
塞	sxoo
豪	hhoe
亦	ymoe
杜	dne
努	nja
判	pco
谋	mlo
胆	dfua
尘	csiu
扎	vqe
滚	gs
闷	mwo
闷	mz
迟	cka
稳	wsu
翼	ymao
诺	n/o
闲	xfoi
灰	heeu
朵	dlua
盛	cge
盛	sve
梁	l;oo
晶	jtia
餐	cri
爆	bbo
伦	lsu
娇	jya
侧	cxu
愣	lvo
鼻	bkui
轮	lse
昏	hwu
抖	dle
陷	xcai
敏	msu
词	cko
慌	hpo
愤	fzo
怜	lfoo
颤	cc
阶	jea
苍	cpe
距	jnia
郑	vvou
川	cru
扫	she
扫	sbe
逼	bi
县	xci
忧	yoo
童	tlo
执	vkei
丢	dou
荣	rle
臂	bmae
逐	vje
傲	rb
戴	dqe
芒	m;e
庆	qv
伴	bcu
袭	xke
供	gou
供	g/u
积	jiu
测	cxo
遥	yhu
阻	fjai
例	lmui
睁	vti
岛	dhu
遗	yki
瞪	dvi
慕	mnei
皱	v/ua
博	ble
幕	mnei
猜	cqu
益	ymou
净	jvo
泽	fdo
炼	lcou
监	jrii
鸡	jia
珍	vwe
伏	fjui
绍	sba
曹	chei
爬	pauu
丫	yqo
炸	vao
炸	vqo
壁	bmae
涌	yloo
凶	xouo
郎	l;oa
宿	snoo
宿	xlo
宿	x/o
怨	ycu
醉	fxe
拼	pw
迫	p/u
革	gdei
瞧	qhi
奥	rbu
输	suea
莉	lmei
忠	voia
颗	kei
嗯	rwi
佳	jqui
旅	ljo
仁	rsu
鸟	nhu
骗	pca
浩	hbo
塔	taei
胖	pp
绪	xna
枫	ftei
拔	baei
赞	fcue
炮	pbo
傅	fnui
凯	kai
邪	xdea
芳	fpe
浑	hsoo
夺	dleu
宽	kr
堆	de
裂	lxeu
遭	fy
赤	cmei
旋	xfoe
旋	xco
扭	nle
洁	jdoo
浮	fjoo
悉	xiuo
难	nca
擦	cqei
慧	hx
典	dfi
赏	s;
匆	cou
评	pgo
纵	f/a
莲	lfei
雾	wneo
乌	wuu
跃	yxia
壮	vpoe
贴	tei
丰	ftee
隔	gda
健	jcui
辛	xwo
抵	dke
竹	vju
彻	cxuu
摩	mloe
轰	ho
编	bra
肚	dju
肚	dnu
插	cqei
磨	mloe
磨	m/o
哎	rqi
御	ynuu
耐	nqeu
惧	jno
氏	smua
辉	heio
扶	fje
恢	heo
貌	mbu
额	rdo
述	snei
票	pbe
录	lnae
拖	toei
膀	b;
膀	p;u
鹰	yto
孟	mva
递	dmou
瑞	rxee
唇	cseu
暂	fcea
货	h/ui
琴	qsee
踪	foi
码	mae
慰	wxae
蛇	sdi
玲	lge
晕	ywi
晕	yzi
损	sse
轩	xre
粗	cuo
掩	yfei
屁	pm
悠	youi
仰	y;u
零	lgeo
盟	mgi
途	tjuo
贼	fdia
洪	hloo
悟	wnoo
固	gni
讶	yqoa
冬	doua
滑	haoo
甜	tfu
郁	yne
琳	lsee
辆	lpe
乃	naau
猪	vuu
暖	nfia
妮	ni
挣	vte
挣	vvei
旦	dcia
估	guu
坦	tfe
甘	grei
佩	pxu
莱	lae
享	x;o
吼	hli
构	g/ei
粉	fso
萨	sqe
吻	wsi
潜	qfoo
瓶	pgou
偶	rlu
戒	jxe
浓	nloo
毁	hdui
销	xyu
迪	dki
拒	jnei
绕	rba
勒	lxei
勒	le
朗	l;oa
嘻	xiia
尾	wdae
尾	ykae
帐	vpi
废	fxo
延	yfu
敲	qy
烂	lcou
曼	mci
厌	yceu
宜	yko
羞	xoo
喂	wxia
吟	ysi
滴	dio
洲	vooo
爹	deu
艳	ycee
晴	qgi
抚	fjei
缩	soa
协	xdei
央	ypi
悔	hdoo
肖	xyi
肖	xbi
缠	cfa
脆	cxua
痕	hsoe
伍	wjui
寂	jmoo
启	qkoa
翔	x;ou
薄	bhe
薄	blei
薄	b/
侯	hlui
劝	qc
郭	gooe
奴	njau
鸣	mgia
倾	qtu
彼	bkuu
扔	rt
撒	sqei
撒	sae
豫	ynao
检	jfe
针	vwu
耀	ybi
痴	cio
姆	mja
篇	pru
椅	yke
厂	c;eu
董	dlei
熊	xla
埋	maei
乖	gqu
狐	hju
蒋	j;e
踏	tqi
隆	lla
括	k/e
潮	cho
唉	rqia
穷	qlo
聪	coei
唤	hci
泰	tqee
版	bfu
末	m/e
旗	qkoe
仪	ykui
焦	jyu
猫	my
盗	dboe
侍	smui
挤	jkei
款	kf
拾	skei
荒	hpe
强	q;a
姿	fio
域	ynei
搭	dqei
脉	mqu
脉	m/u
授	s/e
俗	sju
融	rlei
狱	ynua
欺	qiei
访	f;o
桥	qhe
锁	slue
霸	bqe
牵	qre
池	ckoo
钻	frue
钻	fcue
港	g;o
喃	nfia
廷	tgue
乘	cgue
玛	maee
奉	fve
扯	cd
岳	yxui
减	jfoe
弯	wr
夹	jae
辞	cku
岸	rci
岂	qki
屈	qua
恼	nho
哲	vdei
季	jmu
召	vba
丧	spe
丧	spei
尝	c;io
恭	goei
载	fae
载	fqe
瘦	s/oe
皆	jee
颇	po
茫	m;ei
染	rfo
肃	sna
爽	s;e
亏	kee
吞	tw
惹	rde
哀	rqo
乔	qhu
趁	cze
铺	puu
铺	pn
脏	fpu
吕	lji
奖	j;o
倍	bxu
汤	tp
振	vzei
婷	tga
牢	lho
扰	rh
溜	lo
溜	l/oo
庞	p;o
臭	c/u
悦	yxoo
赫	hxe
赢	ygo
跪	gxia
麦	mqee
枝	viei
侠	xa
泉	qfui
劫	jdei
炎	yfou
泥	nko
赌	dji
弓	goa
魏	wxu
罩	vbi
疾	jko
饰	smua
符	fjue
垂	cdu
映	yvi
漠	m/oo
脖	blu
饮	ysua
沿	yfoo
懒	lfoo
肤	fuu
桑	spa
堪	kre
燃	rfou
卓	vli
祝	vnoa
赖	lqe
宾	bwo
贾	jaei
喘	cfi
焰	yco
吵	chi
冥	mgo
鞋	xdei
逸	ymu
均	jwei
库	kn
裤	kno
碗	wfeu
航	h;uu
踢	ti
姨	ykau
酸	sre
啸	xbia
龄	lgi
阁	gdo
舌	sdue
箱	xpue
冯	fg
邦	bpe
钢	gpu
霞	xae
促	cnui
泡	pboo
盾	dzu
羊	y;ou
碧	bmee
援	yfei
忌	jmae
结	jeaa
抹	mlei
抹	m/ei
倩	qcu
锐	rxu
喷	pwi
拦	lfei
嘉	jqe
袖	x/oa
殊	sueu
辰	cseu
繁	ffue
络	l/a
抛	pye
嫁	jqau
咒	v/i
撤	cxe
键	jcue
湿	sioo
恰	qq
虫	cli
审	ssoo
献	xce
媚	mxa
贤	xfi
葛	gdei
刹	squ
刹	cquo
袁	yfei
摔	sqei
序	xno
筑	vnu
斜	xduo
瓦	wa
涂	tjo
湾	wro
莎	sqei
崇	clia
猎	lxu
刑	xgee
墨	m/ia
娃	waa
梯	tie
桃	thei
豆	d/e
驾	jqau
浅	qfoo
径	jvuu
饿	rxua
疲	pko
搬	brei
瓜	gquu
莹	ygei
滋	fioo
润	rzoo
铃	lgue
蛮	mfo
蒂	dme
拨	boe
涛	tyo
予	yjao
勾	goua
惠	hxei
析	xie
落	lqei
落	lbe
砍	kfe
撑	cte
截	jdei
措	c/e
币	bmu
薇	weei
愈	ynuo
督	du
酷	kne
祥	x;oa
怖	bno
侵	qwu
岩	yfia
扮	bce
糟	fyo
盈	yga
腹	fnua
斩	vfe
尺	ckae
签	qru
稀	xiue
掏	tye
夸	kqeu
汽	qmoo
液	yxoo
姬	jiau
愧	kxoo
汇	hxo
柱	vnei
粮	l;ou
堡	bhui
仗	vpu
笨	bzu
奏	f/e
歉	qco
甩	sau
怔	vvoo
允	ysao
竞	jvoe
祸	h/o
耶	yee
耶	yde
爵	jduo
绩	jmaa
诱	y/o
呜	wui
穴	xdoo
黎	lku
租	fuue
培	pde
砸	faeu
井	jge
窝	wo
弥	mka
返	ffuu
匹	pke
啥	sai
凑	c/o
奸	jra
陌	m/a
叛	pcou
核	hde
核	hje
卧	w/e
幅	fjia
眨	vai
耗	hbe
洒	sao
怡	ykoo
详	x;oa
卢	ljie
扣	k/ei
哇	wqi
丑	cla
勉	mfua
孝	xbei
矛	mha
氛	fwu
衡	hgu
陶	tha
购	g/i
汪	wpoo
僵	jpu
疗	lhoe
妃	fea
罚	fai
系	jmua
棋	qkei
缝	fga
缝	fva
咐	fni
躯	quu
泛	fco
愁	clue
血	xxu
搜	soei
慈	ckou
肥	fdu
笼	llue
篮	lfu
俱	jnu
惟	wdo
柜	gxe
捉	voe
悬	xfia
霍	h/eo
泄	xxoo
咽	yri
咽	yci
齿	cki
秒	mhu
勤	qsei
扩	k/ei
屏	bg
屏	pga
霜	speo
袍	phoa
蝶	ddi
祭	jmua
夫	fjee
厨	cjeu
胁	xdua
璃	lkee
劈	pia
赚	vcia
锦	jsue
尬	gqeu
尴	greu
熙	xiei
寺	smei
昌	cpia
贺	hxa
巾	jwi
描	mhe
捕	bje
陵	lgai
咳	kd
扇	sro
扇	scoa
虹	hlia
绵	mfa
撕	siei
蔡	cqei
催	ceu
彭	pge
宠	clo
贪	tr
辱	rje
誓	smei
盒	hduo
寸	czei
披	pie
搂	loe
搂	llei
饶	rhu
跌	dei
欠	qcua
肌	jiua
售	s/u
巡	xsa
抑	ymei
纹	wsa
宏	hloo
幼	y/a
萍	pgei
驻	vna
丛	cluo
亿	ymui
播	boei
俄	rdu
刃	rza
蕾	lde
挨	rqei
仲	v/ui
迈	mqea
违	wde
辩	bcoe
埃	rqei
艘	sou
琪	qkee
灾	fqo
僧	stui
渡	dno
卑	beu
雕	dyu
鼠	sjui
讯	xzoa
辣	lqo
刷	sqa
艰	jrao
斥	cmu
裙	qso
翠	cxa
饱	bhua
掠	lxei
询	xso
勃	blei
夕	xku
矮	ra
瑶	yhe
赐	cmi
捏	nee
闯	c;oi
姚	yha
瑟	sxee
渴	kdo
谅	lpoa
昂	r;
串	cci
沟	gooo
涉	sxoo
咕	gui
驶	skaa
摄	sxei
贫	psu
辕	yfea
婉	wfa
答	dque
鹏	pgua
姜	jpo
碍	rqeu
荷	hdei
荷	hxei
冠	groa
冠	gcoa
魅	mxu
玫	mdee
裁	caei
坡	poe
鸿	hloo
邓	dva
歪	wqe
乏	fauo
申	swi
割	geo
巫	wue
衫	sroa
棒	bpei
阔	k/o
泣	qmoo
韦	wdee
恍	h;o
贯	gca
魄	p/ui
柄	bge
患	hcia
覆	fnei
蜜	mmo
婴	yti
励	lmeu
锅	goue
陛	bmai
遮	veo
帕	pqi
咖	gqi
咖	kqi
嫌	xfau
胳	geu
挖	wqei
啪	pqia
矿	kpeu
凄	qio
爪	vhu
爪	vau
眠	mfi
穆	mnu
啡	feia
吾	wjei
坛	tfei
脾	pku
恒	hgo
屠	tja
玻	boee
蓉	rlei
础	cjeu
曰	yei
耸	sluo
膊	blua
逆	nm
寿	s/ee
驱	quaa
猴	hlua
佣	y/ui
毅	ymoe
舅	j/u
铜	tlu
娟	jrau
眯	mki
淫	yso
吩	fwi
匪	fdea
牧	mnue
役	ymuu
寄	jmoo
诡	gdoa
纤	xra
腐	fjoe
姻	ywau
晰	xiia
渊	yro
亭	tgoe
邀	yyui
哄	hoi
哄	hlia
骚	sya
墓	mnei
柯	keei
筋	jwue
崔	ceia
灿	cco
捷	jdei
淋	lso
弗	fjae
辑	jkea
棍	gz
绳	sga
喝	hxi
频	psi
廊	l;oe
畏	wxia
歇	xei
裹	glo
苗	mhei
盼	pci
咯	geia
咯	loi
咯	l/i
耍	saeu
煞	squa
寝	qsoo
瞒	mfia
添	tro
嫂	sha
纠	joa
慨	kao
嚷	r;i
驰	ckaa
拐	gae
宴	ycoo
津	jwo
岚	lfi
浴	ynoo
耻	ckei
挽	wfei
页	yxeu
誉	ynoo
牲	stue
乳	rju
仓	cpuo
逝	smei
喉	hlia
逛	gpua
樱	ytei
兼	jrou
戈	geea
哗	hqia
哗	hai
涯	yao
捧	pgei
铭	mgue
障	vpa
摊	tre
跨	kqia
妥	tluo
揉	rlei
晋	jzei
寞	m/oo
寨	vqoo
漆	qioo
污	wuo
嘲	chia
枚	mdei
吊	dbi
乾	qfei
馨	xwe
伪	wdui
嗓	s;i
呈	cgi
卿	qtua
楠	nfei
籍	jkue
裸	lloa
链	lcu
灌	gcoo
昆	kw
畅	cpia
逍	xyio
帽	mbia
阅	yxoi
逗	d/eo
蹲	dw
踩	caia
窜	ccoo
哑	yai
趴	pqia
逢	fgu
植	vkei
媒	mdau
韵	yzo
昭	vyi
尹	ysae
谦	qro
档	dpei
趟	tpe
趟	tpei
沾	vro
兔	tnu
订	dvo
朴	pje
瞎	xqi
鞭	brei
俺	rfu
斤	jwuu
翅	cmei
肠	c;u
雀	qyi
雀	qhiu
雀	qxi
慎	szo
盆	psuo
迁	qrue
镖	byu
芬	fwe
崖	yaia
丘	qou
蠢	csee
庙	mbo
潘	pro
颖	ygua
拓	t/e
娶	qje
纱	sqaa
漏	l/oo
谨	jso
珊	sree
和	hxu
仆	pju
曾	ftou
宙	v/o
尉	ynae
屑	xxa
叮	dtia
捂	wjei
涩	sxoo
诧	cqoa
柴	caie
杆	grei
杆	gfei
涵	hfoo
坠	vx
赔	pdi
涨	v;o
涨	vpoo
嘟	dui
崩	bti
薛	xee
藤	tgei
税	sxue
枯	kue
译	ymoa
帘	lfoo
糖	t;ou
愉	yjoo
骄	jyaa
羡	xcou
糕	gyo
彬	bwe
愚	yji
疏	sua
翰	hcei
堵	djei
腕	wcu
眸	mli
芸	yse
溪	xio
殷	ywu
谎	h;oa
鼎	dgi
稿	ghu
哟	yoia
冤	yroa
症	vto
症	vvoe
棵	keei
狄	dkua
咧	ldia
湘	xpo
宛	wfo
嫩	nz
肆	smei
宰	fao
憾	hcoo
偿	c;ui
腔	qpu
哩	li
豹	bbu
瑰	geee
鉴	jcii
绑	b;a
潇	xyo
戚	qieu
郡	jzae
澡	fho
桂	gxei
兮	xiuo
雯	wse
颠	drei
狮	siua
邻	lsuo
契	qme
骇	hqa
卜	boi
卜	bji
差	cqou
揭	jeei
妄	wpoe
坑	kt
伐	faui
矩	jju
烁	s/ou
葬	fpei
诀	jdoa
鄙	bki
鹿	lnoe
柏	baei
柏	blei
溃	kxoo
朕	vzua
舟	vouu
妆	vpoe
躁	fbi
霉	mdeo
侦	vwui
冻	d/oe
娅	yqa
庸	yooe
筹	clue
削	xyio
削	xeio
砰	pt
耿	gg
牺	xiue
筒	tlue
遂	sxou
旭	xnu
胎	tqu
惶	h;oo
淑	suo
叉	cqa
痒	y;oe
竖	sni
龟	geua
斑	bree
儒	rjui
嫣	yra
宅	vaoo
押	yqei
胃	wxia
旨	vkua
册	cxua
膝	xiua
浸	jzo
弦	xfae
栏	lfei
衷	vooe
刮	gque
艇	tguu
岗	g;i
赴	fnei
囊	n;e
斧	fjuo
颊	jaeo
疆	jpae
炉	ljou
塌	tqei
乞	qkue
旺	wpi
烤	kho
黛	dqui
逊	xzai
贱	jcia
辨	bcoe
狸	lkua
叙	xnuo
愕	rxo
叠	dda
遣	qfi
晌	s;ia
麟	lsoe
腥	xtu
粒	lmou
拟	nke
俏	qb
杖	vpei
芝	viei
夷	ykea
衬	czo
佐	flui
巷	xpei
捡	jfei
遵	fwou
塑	snou
桶	tlei
泼	poo
滩	troo
琼	qlee
昊	hbi
帆	fri
搏	blei
颈	jga
噢	roi
蹦	bvi
寡	gao
贞	vwi
凰	h;ua
哨	sbi
拆	cqei
茹	rjei
劣	lxiu
嘱	vji
沃	w/o
厢	xpeu
摘	vqei
咋	vqi
咋	faia
咋	fdia
坤	kwe
俯	fjui
媳	xkau
赋	fnia
嘶	siia
贡	g/ei
碌	lneu
匙	ckia
拢	llei
谭	tfoa
翁	wt
辜	gue
竭	jdoe
廉	lfoe
械	xxe
贸	mbua
辅	fjea
讽	fgo
呐	nqi
斌	bwoe
辽	lha
填	tfei
窃	qxo
抄	cyei
溢	ymoo
妒	dna
吁	xuia
吁	ynia
嗦	soi
掀	xrei
芙	fjei
祈	qkoa
栋	d/ei
吱	vii
撇	pe
撇	pdei
胞	byua
轿	jbea
禅	cfoa
禅	scoa
妨	f;au
拂	fjei
倦	jcui
衰	sqoe
靖	jvoe
循	xsu
挪	nlei
蓬	pgei
惩	cguu
垃	lqei
账	vpia
驳	bla
署	sji
甫	fjei
顽	wfee
姥	lhau
圾	jiei
熬	rhe
枕	vse
丐	gqei
茜	qce
咦	ykia
厕	cxeu
攀	pre
彤	tlua
妍	yfau
拽	vqei
荆	jte
妓	jmau
壶	hjei
寇	k/oo
鹤	hxoa
钥	ybu
骤	v/a
渺	mho
刊	kree
肢	viua
烛	vjo
孕	yza
绽	vca
彦	ycoe
棉	mfe
俘	fjui
盔	keeu
剪	jfou
诞	dcoa
兜	doui
凛	lsoe
岭	lgia
嚣	xyia
溅	jcoo
笛	dkue
舱	cpuu
罕	hfoa
鸭	yqi
债	vqu
噬	smia
钉	dtu
钉	dvu
躬	goui
倚	ykui
缕	lja
咚	doi
撼	hcei
蕊	rdei
侄	vkui
佑	y/ui
雁	yceu
隶	lma
践	jcia
拱	gle
沐	mno
菊	jje
蜂	ftia
裕	ynoa
兆	vbu
搅	jhe
尿	nba
黯	rcia
歹	daeu
蓄	xne
朦	mgua
嘀	dkia
怯	qxoo
叨	dyi
纽	nlaa
聘	pz
腻	nmu
剥	boa
彪	byi
沸	fxoo
氓	mgoe
卷	jcou
榜	b;e
榜	bpei
榜	pve
逻	llia
壳	kde
壳	qbe
储	cju
憋	beo
啤	pki
匠	jpe
悍	hcoo
昧	mxi
泊	blo
泊	pooo
篷	pgue
烫	tpo
狡	jhua
轨	gdea
汹	xooo
携	xdei
磊	ldeu
隙	xmai
仑	lsuo
摧	cee
瞄	mhi
胧	llua
趋	que
挠	nhe
煌	h;ou
擅	scei
卒	cno
卒	fjoe
饼	bgu
狭	xau
丸	wfu
惫	bxua
瞅	clia
卡	qa
犬	qfeu
砖	vre
矣	ykao
楞	lve
昔	xiei
裳	spio
裳	c;io
骆	l/aa
雇	gno
阎	yfoi
骷	kui
鸦	yqea
妞	no
墅	snia
焚	fse
谱	pjo
属	vja
绘	hxaa
梳	suei
肿	vlu
魁	kdu
耽	drei
擒	qsei
陡	dla
璋	vpee
茂	mbe
蹄	tkia
瞥	peo
瞳	tlia
髅	llia
绣	x/a
硕	s/eu
肺	fxu
参	cwa
参	swao
参	sra
兹	fiou
炒	chou
邮	yli
弘	hlae
嫉	jkau
届	jxa
嗡	wti
娱	yjau
喧	xri
脂	viua
膛	t;ua
沧	cpo
疚	j/o
盐	yfei
扁	bfo
扁	proa
搁	geei
茅	mhei
滔	tyoo
坟	fsei
掐	qqe
瑜	yjee
邱	qoui
桐	tlei
茵	ywe
苹	pgei
旷	kpi
翘	qbea
郝	hhe
蓦	m/ei
诈	vqoa
沫	m/oo
菁	jtei
粹	cxou
琢	vle
腊	lqu
钦	qwue
喻	ynia
宪	xcoo
锻	dcue
睹	djia
郊	jyoe
饥	jiua
侃	kfu
粘	vrou
媛	yfau
谊	ymoa
恳	ksa
厮	sieu
锤	cdue
凳	dvao
淮	haoo
蔽	bmei
聂	nxe
贩	fci
潭	tfoo
翩	proa
呻	swia
枉	w;e
拘	jue
煮	vjei
焉	yre
址	vkei
匕	bkua
渗	szoo
览	lfii
敦	dwo
厦	sqeu
蕴	yze
冉	rfi
薪	xwei
呃	rxi
峻	jzi
荐	jce
栽	fqei
嚎	hhi
汁	vio
傍	bpu
秃	tuu
磕	keeu
禀	bgo
珑	llee
坎	kfei
邵	sbau
萌	mgei
窄	vaoo
阮	rfa
蹈	dhi
碑	beeu
婶	ssa
煤	mdo
寓	ynoo
栈	vcei
滞	vmoo
倘	t;ui
杭	h;ei
暇	xai
藏	fpei
狈	bxua
峡	xaia
侣	lju
芦	lje
蔓	mce
蒸	vtei
禄	lnoa
胀	vpua
醋	cne
淌	t;oo
伞	sfu
姊	fka
钩	goue
衍	yfuu
妾	qxoe
嘎	gai
蜀	sjia
蝴	hjia
萝	llei
莽	m;ei
弩	njau
祷	dho
稚	vmue
圳	vzei
徽	heu
衙	yau
咸	xfe
陋	l/ai
奢	see
罐	gcu
霄	xyeo
毙	bmea
汝	rjo
敞	c;io
暮	mnei
嘘	xuia
灼	vlou
澜	lfoo
姗	srau
倪	nku
挫	c/ei
咪	mi
钧	jwue
捣	dhe
燥	fbo
泳	yloo
眶	kpia
乙	ykaa
澈	cxoo
焕	hcou
酬	cle
筷	kqu
宵	xyoo
揪	joe
缚	fnaa
蚁	ykia
喇	lai
丞	cgai
拎	lw
吓	hxia
棠	t;i
咙	llia
梭	soei
哧	cii
棺	grei
璇	xfee
瀚	hcoo
肝	gru
敛	lfuo
剂	jmoe
疤	bqo
渔	yjoo
嗔	cwi
沮	jjo
廖	lbo
虏	ljie
皓	hbu
勋	xwi
恕	snau
虐	nxi
虞	yjie
综	foa
瘾	ysoe
驴	ljaa
晒	sqia
卦	gqei
迦	jqau
陀	tlai
窥	keo
堕	d/a
哆	doia
葡	pjei
帖	tdi
垫	dcei
屡	ljae
鹅	rdue
蛛	vui
盲	m;o
碟	dde
狞	ngu
囚	qli
诊	vso
揽	lfei
裴	pdie
捞	ly
吏	lmei
铮	vtue
萄	thei
盏	vfee
霆	tgeo
喔	woi
贷	dqui
给	jkaa
勿	wnua
吭	kti
淘	thoo
辟	bmae
辟	pma
蔑	mxei
淹	yroo
麒	qkoe
喽	loia
栗	lmei
绷	bta
惚	huo
桓	hfei
坊	fpei
桩	vpei
嗽	s/i
履	ljae
璐	lnee
菩	pjei
巢	cha
畜	cnoe
畜	xnoe
兀	wneu
樊	ffe
锡	xiue
棚	pgei
仕	smui
倏	suui
芹	qsei
僻	pmu
絮	xnau
杏	xvei
浆	jpoe
浆	jpoe
啧	fdia
瘫	troe
磁	ckeu
冈	gpia
逮	daa
逮	dqa
搓	coei
赠	fvi
胶	jyua
脊	jkoe
噩	rxei
绰	c/a
呕	rli
嚼	jhi
嚼	jdi
谐	xdoa
舍	sxuo
歼	jre
揣	cqei
揣	caei
殖	vkeu
拧	nge
伺	cmui
伺	smui
霖	lseo
驼	tlaa
襄	xpoe
衔	xfuu
惕	tmo
掷	vmei
卸	xxue
炽	cmo
敖	rhee
惭	cfoo
框	kpei
捆	kse
眩	xcia
蝉	cfia
谜	mkoa
炫	xcou
塘	t;e
阱	jgai
膜	mlu
亨	hto
奕	ymoe
蚂	mai
蚂	mqia
猩	xtua
滨	bwoo
沁	qz
跋	bai
藩	fre
舔	tfue
捐	jrei
歧	qkie
隋	sdai
蹭	cvi
甄	vwei
蜡	lqia
嗤	ciia
缸	gpue
嬉	xia
哮	xyia
熄	xiou
窍	qbo
俞	yjuo
豁	haoo
豁	hoo
豁	h/oo
垒	lda
掘	jdei
琦	qkee
屎	skae
乍	vque
孽	nxei
毯	tfue
弧	hja
槐	hae
铠	kau
挟	xdei
襟	jwoa
梨	lkue
嗅	x/i
祁	qkoa
纲	gpa
渠	qjo
矢	skue
捅	tlei
扛	k;e
朽	xle
忖	cso
匈	xoua
扒	bqei
扒	pae
雍	yooe
莺	ytei
侮	wjui
闺	geoi
霓	nkeo
斋	vqoe
稽	jiue
夭	yyue
沦	lsoo
揍	f/ei
瞟	phi
苟	glei
琉	llee
漪	yio
暑	sjia
窟	kuo
钓	dbue
鳞	lsua
瓷	ckoe
萱	xrei
株	vuei
倭	wou
鞘	qbei
沛	pxo
噜	lu
绞	jha
颓	tdue
睿	rxie
噗	pui
唔	wjia
幢	vpia
喀	kqia
诅	fjoa
涕	tmoo
拣	jfei
谣	yho
叽	jii
葱	coei
拭	smei
婢	bmau
铸	vnue
绮	qkaa
剿	jhaa
胤	yzua
秩	vmue
畔	pcia
粥	voae
奎	kdeu
绸	claa
茨	ckei
觉	jbo
熏	xwue
蹬	dvia
诏	vbo
岔	cquo
叭	bqia
咆	phia
滥	lcoo
梧	wjei
垮	kae
澳	rbo
浙	vxo
甸	dcua
绯	feaa
诛	vuoa
鲍	bbua
刁	dya
厥	jdeu
蚊	wsia
鞠	juei
歆	xwoe
拙	voei
茗	mgei
眷	jcou
戮	lnao
唬	hjia
骏	jzaa
扳	brei
踹	cqi
漓	lkoo
蝇	ygi
擂	lxei
涡	woo
沌	dzo
凸	tui
蚩	cia
酿	np
唾	t/i
琐	slee
犀	xiae
澄	dvoo
澄	cgoo
哉	fqei
猾	haua
煎	jrou
窒	vmoo
虾	xqia
蝠	fjia
钞	cyu
瓣	bcoe
唧	jiia
觑	qni
哽	ggi
娥	rda
婿	xnau
讪	scoa
耕	gt
葫	hjei
暧	rqia
浇	jyoo
嗨	hqia
诵	s/oa
疫	ymoe
兢	jtei
箫	xyue
颅	ljie
啼	tkia
绅	swaa
杉	srei
嗜	smia
券	qcou
遁	dzuu
炯	jlo
霎	sqeo
讥	jioa
迭	ddu
彷	p;uu
觅	mmuo
娴	xfau
抿	mse
剔	tii
稻	dbue
敷	fue
泻	xxoo
怠	dqao
龚	goeu
绒	rlaa
讳	hxoa
勺	shu
函	hfa
喳	cqia
颂	s/uo
搀	cre
撩	lye
擎	qge
巍	wei
脯	fjua
脯	pjua
镶	xpue
寥	lhoo
漾	ypo
缴	jhaa
藉	jkei
藉	jxei
弊	bmou
逞	cgia
膏	gyoe
戳	coa
呛	qpi
凹	ry
叩	k/i
禽	qsu
懊	rboo
懈	xxoo
蛟	jyi
亢	kpoe
呸	pei
芊	qrei
慑	sxoo
跺	d/i
跄	qpia
蚀	skua
栖	qiei
蔚	wxei
铲	cfue
坪	pgei
筝	vtue
顷	qgea
腮	squa
别	bxia
踉	lpi
划	haea
当	dpi
狰	vtua
踱	dli
嗖	soia
苑	ycei
秉	bgue
猿	yfua
堤	die
佟	tlui
悯	mso
唠	lhi
唠	lbi
憨	hra
肘	vlua
拇	mjei
僚	lhu
霹	pieo
婕	jdau
禹	yjui
啃	ksi
匀	ysua
颤	vcoe
晖	heia
怅	cpoo
聋	lleu
拯	vge
忿	fzu
韧	rze
邹	foua
梢	sye
肋	lxua
窘	jloo
嵌	qci
婪	lfei
辖	xaea
浦	pjoo
炭	tci
曦	xiia
簇	cnue
螺	llia
酱	jpoe
屯	ts
悴	cxoo
匡	kpea
冀	jmi
倔	jdui
橙	cgei
陕	sfa
筱	xhu
叱	cmia
髓	sdia
淳	csoo
矜	jwao
詹	vru
菱	lgei
芷	vkei
惺	xtoo
浊	vloo
囔	npi
朔	s/ou
憔	qhoo
睫	jdia
睬	caia
鸽	geuo
臀	tsa
吨	dwi
笙	stue
戟	jkei
沼	vhoo
谍	ddo
昕	xwia
蛊	gjia
煜	ynou
祀	smoa
罡	gpia
伶	lgui
荫	ywei
荫	yzei
酥	suei
懦	n/oo
厄	rxeu
峨	rdi
轴	vlea
伽	jqui
雳	lmeo
卵	lfua
捶	cde
檐	yfei
棘	jkei
嗣	smia
钗	cque
袜	wqo
妩	wja
炕	kpou
偎	weui
窦	d/oo
蝎	xeia
溶	rlo
膨	pgua
峙	vmia
缉	jiaa
徊	hauu
呗	beia
衅	xzu
砂	sqeu
舵	d/u
昼	v/ae
迸	bvou
斟	vwei
舆	yjui
椒	jye
靓	lpee
旬	xsua
厘	lkeu
窑	yhoo
萎	wdei
涟	lfoo
疙	geoe
瘩	dqo
瘩	dao
梵	fcei
靴	xeei
侥	jhui
匿	nme
挚	vmei
镯	vlue
兑	dxo
尧	yhea
徘	pauu
芽	yaei
狙	juu
闵	msoi
辫	bcoe
瀑	pno
嗷	rhi
庐	ljoe
芯	xwei
禾	hdue
澎	pgoo
邢	xgee
绊	bcaa
蜘	viia
憎	ftoo
靡	mkoe
靡	mkoe
褚	vjoa
湛	vcoo
蒲	pjei
嚓	cqia
珂	keee
崽	faia
贬	bfi
惮	dcoo
婵	cfau
嗒	tqia
悸	jmoo
晦	hxia
涅	nxo
恬	tfoo
慷	kpoo
穹	qloo
渣	vqoo
屉	tma
缭	lhaa
绢	jcaa
袱	fjoa
黝	ylia
袅	nhua
淇	qkoo
茄	jqei
茄	qde
寅	ysoo
赦	sxei
祟	sxa
榻	tqei
蛙	wqia
苇	wdei
嵩	soia
茉	m/ei
咏	ylia
凿	fhi
粪	fzou
噪	fbia
菌	jwei
蝙	bri
庶	snoe
邸	dkua
禧	xkoa
攒	ffei
旱	hcia
虔	qfie
榴	llei
琛	cwee
漱	snoo
忑	txe
匣	xaea
忐	tfie
谬	m/oa
蟒	m;i
棱	lgei
钝	dzue
悚	sloo
廓	k/oe
惘	w;oo
漉	lnoo
蟹	xxua
佬	lhui
曳	yxia
赎	sjia
壤	r;e
忡	cooo
倡	cpui
冶	ydo
竿	grue
蜷	qfia
癌	rao
嘈	chia
蚕	cfee
剖	pooe
颁	bruo
缀	c/aa
汀	tto
谕	ynoa
牡	mju
斐	fdie
懵	mgoo
分	fzuo
斗	dlo
皙	xiei
缪	mba
缪	mla
蔷	q;ei
诫	jxo
恤	xnoo
咄	doia
馒	mfua
矫	jhue
矫	jhue
痞	pkoe
橘	jjei
氧	y;ue
贿	hxia
肮	rpu
瑾	jse
烙	lbou
璧	bmae
攘	r;ei
攥	fcei
肖	xbio
汰	tqoo
溺	nmo
铅	qrue
咔	kaia
芭	bqei
戎	rlea
褐	hxoa
巩	glei
吆	yyi
彰	vpoe
漩	xfoo
聆	lgei
蒜	scei
棕	foe
鹃	jria
帜	vmia
鄂	rxia
搐	cnei
蔼	rae
怦	pto
穗	sxue
亩	mjo
撰	vcei
绎	ymaa
牟	mlao
咨	fioe
奄	yreu
梓	fke
亲	qvo
绚	xcaa
阀	faoi
烘	hoou
炙	vmua
翎	lguo
惋	wfoo
驯	xzaa
栩	xje
逾	yjuo
墟	xue
鬟	hfei
茬	caei
褪	txo
鑫	xwuo
骸	haia
峭	qbi
缅	mfaa
灶	fbou
洽	qqo
祯	vwo
暄	xria
裔	ymoe
韶	sho
缎	dcaa
砚	yceu
锥	veue
辙	vdea
惦	dcoo
铛	ctu
枣	fhe
桦	hqei
邃	sxoo
橱	cjei
搔	syei
腑	fjua
解	xxua
萤	ygei
枢	suei
遏	rxia
募	mnei
憬	jgo
庵	rro
叼	dyia
嫖	pha
苛	keei
锣	llue
蹑	nxia
拌	bcei
奠	dcou
秽	hxue
殴	roe
喋	ddia
糙	cyo
貂	dyuo
揖	yiei
葵	kdei
榆	yjei
颐	ykei
皂	fbu
眈	dri
扼	rxei
眺	tbi
孜	fia
簌	snu
玺	xkua
偌	r/u
蹿	cria
蓓	bxe
弛	ckae
庇	bmoe
檀	tfei
枭	xyua
螂	l;ia
趾	vkia
崭	vfi
妲	daau
掂	drei
醇	csei
掺	crei
驿	ymaa
槽	chei
惬	qxoo
镰	lfue
抡	lwe
憧	cooo
删	sru
鸳	yru
酣	hre
宦	hcoo
筐	kpu
琅	l;e
瞻	vria
飙	byeu
湃	pqoo
俨	yfui
跷	qyia
栅	vqei
栅	srei
撅	jeei
煽	srou
呱	guia
缰	jpaa
猝	cnua
衮	gso
肴	yhuo
殆	dqeu
谴	qfoa
蔬	suei
飒	sqoe
婧	jva
阐	cfoi
荧	ygei
侈	ckui
霏	feeo
瘟	wwo
芜	wjei
俭	jfu
崎	qkia
亥	hqoe
俐	lmui
屿	yjia
譬	pmae
饺	jhua
垄	lleu
畴	clia
杠	gpe
鬓	bze
讼	s/oa
晏	ycia
弈	ymoe
鞍	rre
瘸	qdo
钮	nlu
珏	jdee
钰	ynue
傀	kdui
噔	dtia
驭	ynaa
靶	baei
萦	ygei
韬	tyee
恙	ypou
懿	ymei
竺	vjue
吝	lzo
羁	jiia
荀	xse
癫	droe
嘭	pti
菇	guei
恃	smoo
儡	ldu
瘪	beoe
瘪	bdo
踌	clia
呦	yoia
榕	rlei
昵	nmi
躇	cji
烬	jzou
啰	loia
酌	vlei
丙	bgei
涎	xfoo
哒	dqia
冽	lxoe
砌	qmeu
鸾	lfoe
烨	yxou
翟	vaa
翟	dka
辗	nfea
噎	yeia
驹	jua
噼	pii
咎	j/ua
亵	xxoe
陨	ysai
蠕	rji
冕	mfia
雌	ckie
茸	rlei
瑛	ytee
剃	tmou
掰	bque
蹙	cneu
橡	xpei
佯	y;ui
笃	djue
崛	jdia
勘	krei
稼	jque
桀	jdua
渝	yjoo
汐	xioo
锈	x/u
磅	bpeu
壕	hhei
娄	llou
撮	coei
撮	flei
玑	jiee
祠	ckoa
娲	wqa
鹫	j/oe
黏	nfu
珀	p/e
睽	kdi
栓	srei
绫	lgaa
阑	lfoi
邑	ymia
瑕	xaee
磋	coeu
粟	snei
薯	sje
沪	hnoo
讷	nxoa
岑	csia
炜	wdou
玮	wdee
娼	cpa
迂	yu
伎	jmui
鲸	jtu
翡	fdie
坝	bqei
铐	kbu
洼	wqoo
蹊	xiia
寐	mxo
肾	szii
鸯	ypia
敝	bmou
涧	jcoo
崆	ko
甭	bgeu
笠	lmue
扈	hnoa
哝	nli
芮	rxei
卉	hxei
靳	jzei
诬	wuoa
札	vae
婊	bha
裘	qlei
扉	feo
疮	cpoe
巅	dria
坞	wnei
膳	scu
鳄	rxua
捺	nqei
悼	dboo
茧	jfei
毋	wjaa
曙	sjia
馅	xcu
簸	blue
簸	b/u
忒	tee
奇	jieu
叟	slui
拴	srei
嬷	mqa
稣	suua
痹	bmoe
垣	yfei
蛤	gdi
蛤	haia
谏	jcoa
羹	gto
沥	lmoo
蛾	rdia
瑚	hjee
熔	rlou
惆	cloo
雏	cjua
饷	x;u
拗	rbe
拗	n/e
燎	lhou
熠	ymou
薰	xwei
蕃	ffei
捋	ljei
籁	lque
髦	mhei
飓	jnua
簿	blue
簿	bnu
迢	thau
闸	vaoi
狩	s/ua
鲨	sqoo
蜥	xiia
惴	vxoo
胯	kqua
侨	qhui
劭	sbau
烹	ptoe
咣	gpia
攸	youi
锄	cjue
硝	xyeu
颔	hcu
鸥	roea
滕	tgua
寰	hfoo
紊	wsoe
蕉	jyei
稠	clue
蟆	maia
垢	g/ei
楷	kaei
炊	ceo
忻	xwoo
炳	bgou
腆	tfua
褒	byo
酋	qlou
赃	fpi
拈	nr
拈	nfei
抒	suei
孰	sjoe
袄	rho
褂	gqoa
孺	rja
胭	yrua
赘	vxe
嫡	dkau
礁	jyeu
啜	c/i
钳	qfue
晾	lpia
茎	jtei
隧	sxai
窿	lloo
骋	cgaa
嫦	c;a
掳	ljei
槛	kfei
莞	gfei
莞	wfei
瓢	phe
曜	ybia
锯	jnue
猖	cpua
遐	xaa
蹋	tqia
飕	soua
渍	fmo
麾	heoe
猥	wdua
篝	goue
殉	xze
枷	jqei
蜒	yfia
皎	jhui
霁	jmeo
诩	xjo
窖	jboo
咫	vkae
檬	mgei
乒	ptu
奚	xiuo
淤	yuo
父	fjuo
溯	snoo
凋	dyo
纺	f;aa
篱	lkue
泌	mmoo
刨	bbua
刨	phu
樵	qhei
忏	ccoo
盎	rpi
戾	lmoa
阿	re
咀	jji
屹	ymia
冲	c/oe
挎	kqei
羔	gyou
殃	ype
庚	gtoe
淼	mhia
淀	dcoo
隘	rqai
绛	jpaa
缨	yta
璨	cce
跤	jyia
锵	qpue
摁	rzei
痊	qfoe
嫔	psa
臻	vwea
泯	msoo
糜	mdoe
睦	mni
喵	myi
缥	pya
褥	rno
魇	yfeu
汶	wzo
馋	cfua
渎	djoo
蜿	wri
抠	koe
诶	reo
墩	dwe
棣	dmei
沓	tqia
喏	rdia
诲	hxoa
琶	paee
缈	mhaa
缔	dma
酝	yzei
耷	dqeu
弼	bmae
柬	jfei
浏	lloo
拷	khe
剁	d/ua
柿	smei
琵	pkee
沂	ykoo
捻	nfei
帛	blui
柠	ngei
饵	rkua
撂	lbei
娓	wdau
乓	ppu
轲	keea
髯	rfe
娉	pta
尽	jsa
圭	geei
璀	cdee
苔	tqei
苔	taei
肪	f;ua
吮	ssi
瞩	vjia
啄	vlia
帷	wdia
箍	guue
蟑	vpia
炖	dzou
梗	gge
捎	syei
嗬	heia
蘑	mlei
唏	xiia
鹊	qxei
矶	jieu
羌	qpo
骼	gdia
筛	sque
鲤	lkua
羲	xiou
祺	qkoa
馈	kxu
伫	vnui
羿	ymao
苞	byei
犁	lkue
啬	sxei
舷	xfuu
矗	cnei
癖	pkoe
掣	cxue
匾	bfe
瀛	ygoo
谧	mmoa
珞	l/e
毓	ynue
衲	nqo
恺	kaoo
纬	wdaa
惰	d/oo
嘤	ytia
诣	ymoa
谛	dmoa
藻	fhei
啷	lpia
佘	sduo
黠	xaia
饲	smua
虬	qlia
涤	dko
骡	llaa
钵	bou
邯	hfei
笋	ssue
芥	jxei
醺	xwei
佼	jhui
舜	szuo
龌	w/i
簪	frue
痰	tfoe
论	lsoa
蹂	rlia
恻	cxoo
簧	h;ue
甥	stue
腼	mfua
单	cfou
单	scou
驮	tlaa
缤	bwa
潺	cfoo
獠	lhua
筏	faue
锭	dvue
阙	qeo
阙	qxoi
粤	yxui
瞌	keia
琏	lfee
龊	c/ie
椎	vee
唆	soia
煦	xni
嵋	mdi
幡	fria
翌	ymao
毡	vrue
碳	tceu
鸨	bhua
闽	msoi
躏	lzi
蜓	tgi
咻	xoia
捍	hcei
睨	nmia
鼾	hru
桔	jjei
娆	rha
抉	jdei
蜻	qti
徨	h;uu
嗲	dai
碾	nfeu
哐	kpia
粼	lsou
啐	cxi
谑	xxoa
嚏	tmi
鳖	beou
榨	vqei
倜	tmu
稷	jmue
篡	ccu
晤	wni
肇	vboa
咂	fqi
帚	vla
瘤	lloe
瞠	cti
嚅	rjia
怆	cpoo
撵	nfei
裆	dpo
腺	xcua
骁	xya
坷	kdei
螃	p;i
冢	vloa
锢	gnu
濒	bwoo
蝗	h;ia
烽	ftou
莘	swei
辘	lnea
撬	qbei
瓮	wv
亘	gze
钊	vyu
篓	llue
缇	tka
宸	csoo
胄	v/ia
鞑	daei
羚	lgou
绥	sdaa
笺	jru
荤	hwe
迄	qmu
踞	jnia
桨	j;oe
慵	yooo
噤	jzia
幌	h;ia
跚	sria
袒	tfoa
浣	hcoo
榄	lfei
痪	hcoe
荼	tjei
阉	yroi
腋	yxua
骰	tlia
曝	pni
涮	scoo
踵	vlia
炬	jnou
涣	hcoo
俟	smui
皑	rau
瞑	mgia
渲	xcoo
擞	slei
赂	lnia
湮	yroo
麓	lnei
铿	ktu
埔	pjei
峦	lfoe
涓	jroo
掬	juei
怏	ypoo
莓	mdei
萃	cxei
呲	fii
蹒	pfi
鳌	rhee
睐	lqia
昱	ynia
和	hjue
和	h/ue
旌	jtoe
摞	l/ei
吠	fxia
濮	pjoo
谙	rroa
啕	thi
轶	ymea
搪	t;ei
陇	llai
纨	wfaa
膺	ytoe
皋	gyu
霭	raeo
呓	ymia
橄	gfei
纶	lsa
垛	d/ei
嗫	nxia
盅	voia
踝	haia
臧	fpeu
淅	xioo
岌	jki
岱	dqui
璞	pjee
缄	jraa
秧	ypu
翱	rhui
卤	ljie
逅	h/uu
靥	yxeu
磐	pfuu
壑	hxie
斓	lfoe
翊	ymoe
挛	lfoe
叁	srao
佗	tlui
阖	hdoi
怂	sluo
戬	jfei
汲	jkoo
垠	ysei
迥	jli
咛	ngi
邂	xxua
杞	qkei
痘	d/oe
臊	sbu
藕	rlei
媲	pmau
湄	mdoo
癞	lqoe
辄	vdea
獒	rhee
恪	kxoo
砾	lmeu
痉	jvoe
蜕	txi
椰	yeei
差	ciou
仨	squi
纣	v/aa
馁	nd
蜈	wjia
镐	ghue
窈	yhoo
秤	cvu
粱	l;oo
辐	fjea
悖	bxo
涔	csoo
偕	xdui
渭	wxoo
汴	bcoo
蜴	ymia
桅	wdei
隅	yjai
卯	mhua
骜	rbee
孚	fjuo
禺	yjia
琥	hjee
杵	cjei
掖	yeei
畸	jiia
晔	yxia
婀	rea
菡	hcei
噶	gaia
昙	tfia
坍	trei
俑	ylui
滤	lnoo
侏	vuui
潦	lhoo
挲	soo
硫	lleu
俸	fvu
蟠	pfia
弋	ymea
梆	bpei
驸	fnaa
笈	jkue
忱	csoo
恿	ylao
龟	jwua
胥	xua
垦	ksae
窕	thoo
滇	droo
珅	swee
圃	pji
咿	yii
徙	xkuu
瘴	vpoe
舫	f;uu
嗝	gdia
泞	nvo
藐	mhei
赣	gcoe
鹦	ytia
逵	kdei
戍	sneu
榭	xxei
揩	kqei
熹	xiei
蟾	cfia
霾	maeo
蔫	nre
跛	bli
岐	qkia
脐	qkua
糗	qlou
螳	t;ia
哺	bjia
鹭	lnia
蚣	goi
嵬	wdia
褶	vdo
恸	t/o
隽	jcui
玥	yxee
籽	fko
釜	fjuo
剐	gaia
鸠	jou
磷	lseu
娑	sooo
巳	sma
谄	cfoa
恣	fmoe
猬	wxua
酪	lbei
丕	pieu
溟	mgoo
隼	ssui
芋	ynei
觊	jmia
筵	yfue
娣	dmau
盹	ds
涸	hdoo
劾	hdoe
颌	hduo
殇	speu
轧	yqea
沽	guo
愫	snoo
鸢	yrea
玷	dcee
掸	dfe
溥	pjoo
疵	cioe
皖	wfui
杳	yhei
镀	dnue
祎	yioa
鹉	wjee
匍	pjua
崴	wai
岖	quia
幔	mcia
蝈	goia
镑	bpue
臆	ymua
偃	yfui
蜗	woia
瞰	kc
侬	nlui
郸	drou
缆	lfa
袂	mxoa
诠	qfoa
犊	djue
摹	mlei
蟀	sqia
邋	lqa
竣	jzoe
骥	jmaa
泗	smoo
痣	vmoe
贲	bwei
胴	d/ua
潼	tloo
弑	smuo
匐	fjua
姣	jyau
谤	bpo
蘸	vcei
蟋	xiia
渥	w/oo
浒	hjoo
蛐	quia
阂	hdoi
糯	n/ou
愠	yzoo
嵇	jiue
谒	yxoa
舀	yhuo
否	pkeu
呤	lgia
槟	bwei
嘣	btia
脓	nlua
樟	vpei
忪	vooo
蛰	vdei
咤	vqia
阜	fnui
峥	vtia
濡	rjoo
遢	tqia
担	dfei
瑙	nhee
碉	dye
孵	fuua
讹	rdoa
彝	ykaa
颀	qkuu
篆	vcue
臾	yjui
椭	tlei
沏	qioo
颦	psie
蛆	quia
淆	xho
揄	yjei
压	yqeu
嗑	kxi
踮	dfia
犷	g;u
荔	lmei
鳅	qoua
闫	yfoi
隗	wdai
渤	bloo
馍	mlua
锏	jfue
楣	mdei
蜃	sze
遛	l/u
查	vqei
倌	grui
氤	ywue
戌	xueu
嶙	lsia
馗	kdua
匮	kxea
揶	ydei
胚	peu
啻	cmoe
敕	cmei
夙	snua
珈	jqee
锹	qyu
摒	bve
迩	rkua
啾	joi
峪	ynia
菠	boei
馥	fnue
槌	cdei
褛	ljoa
贻	ykia
礴	bleu
豚	tsu
氲	ywue
湍	troo
腌	yrua
蚱	vqia
殡	bzeu
毗	pkia
耙	paee
诽	fdoa
褴	lfoa
瘁	cxoe
蚌	bpi
铝	ljue
蔻	k/ei
憩	qmue
锚	mhue
濑	lqoo
耘	ysee
俾	bkui
鬃	foei
裟	sqoo
苒	rfei
蘅	hge
鱿	ylua
傥	t;ui
袈	jqau
豺	cauo
町	tgia
掇	doei
坯	piei
戛	jaeu
贮	vnia
塾	sjoe
剽	pyei
孬	ny
衩	caoa
镣	lbu
戊	wneu
犟	jpae
酉	ylei
斡	w/ei
匝	fqea
诘	jdoa
攫	jdei
潢	h;oo
黔	qfia
臃	youa
罂	ytia
轼	smea
酗	xnei
嘹	lhia
阪	bfa
冗	rloa
桧	gxei
皿	msi
囡	nri
辍	c/ea
觎	yjuo
浚	jzoo
闰	rzoi
臼	j/ui
蹩	bdou
煲	byui
怵	cnoo
囤	tsi
罔	w;ia
蚓	ysia
碴	caeu
灸	jlua
蚯	qoi
嗥	hhia
堑	qcea
箴	vwue
谗	cfoa
嵘	rlia
箩	llue
碱	jfeu
葆	bhei
旎	nkoe
谆	vwoa
粽	f/ou
牒	ddui
泸	ljoo
刽	gxu
诋	dkoa
缜	vsa
爻	yhuo
贰	rme
坳	rbei
睑	jfi
葭	jqei
妪	ynau
镂	l/ue
癸	gdao
笆	bque
壬	rsue
绉	v/aa
抨	pte
叵	ple
箕	jiue
坨	tlei
颉	jdei
姹	cqau
赳	joei
焊	hcou
淬	cxoo
纭	ysaa
埠	bnei
泱	ypoo
恹	yroo
榛	vwei
酵	jbei
銮	lfoe
佶	jkui
犒	kbue
茱	vuei
饪	rzu
孪	lfoe
砺	lmeu
遽	jnie
嗟	jei
钙	gque
谚	ycoa
鲲	kwu
谟	mloa
馊	soua
雉	vmue
虱	siau
糠	kpou
赈	vzi
旮	gqua
骠	bya
峋	xsi
跆	tai
瘠	jkoe
饕	tyi
佚	ymui
淄	fioo
谀	yjoa
镳	byue
读	d/oa
廿	nce
喟	kxia
偻	llui
绺	llaa
骨	guia
沱	tloo
囱	coui
兖	yfoe
袤	mboe
畿	jiaa
诌	vooa
苯	bse
佻	tyu
魈	xyui
屌	dhae
谲	jdoa
泾	jtoo
獗	jdua
蹶	jdia
绔	kna
雹	bheo
旯	laia
洱	rko
馄	hsua
粲	ccie
哂	ssia
蔗	vxei
饨	tsua
奘	fpa
芍	shei
淞	sooo
腴	yjua
剜	wroo
汾	fsoo
顼	xuee
濂	lfoo
蜚	fdie
殒	yseu
鹞	ybuo
蚤	fha
浃	jqo
坂	bfei
颚	rxia
忤	wjo
眦	fmi
彗	hxee
暹	xria
赧	nfei
佝	goui
钺	yxue
嘞	lei
硅	geeu
玳	dqee
蛹	ylia
睾	gyui
盂	yjee
赁	lzu
瑁	mbee
骛	wna
宕	dpoo
纂	ffue
堰	ycei
厩	j/e
萋	qiei
帔	pxi
杈	cqei
熨	yzae
挞	tqei
觐	jzei
煊	xrou
钏	ccue
泫	xcoo
迳	jvao
缮	sca
燧	sxou
孱	cfae
懑	mzo
柩	j/ei
漕	choo
鹄	hjue
龛	kru
饯	jcua
餮	txeu
幄	w/ia
鹘	gjia
倨	jnui
诙	heoa
锃	fvue
颧	qfei
纰	piaa
鏖	rhoe
氢	qtue
楔	xeei
藜	lkei
栀	viei
谥	smoa
骧	xpaa
犄	jiue
葳	weei
魑	ciu
聒	goei
椿	cwei
伢	yaui
谩	mfoa
鹜	wnao
燕	yrei
闩	sroi
颍	ygua
濠	hhoo
仞	rzui
鳗	mfua
踊	ylia
痿	wdoe
皈	geui
骊	lka
孑	jdai
帼	glia
撸	lue
檄	xkei
啵	boia
柚	y/ei
篑	kxue
陲	cda
潋	lcoo
樽	fwei
遨	rhee
舶	bluu
莆	pjei
蛀	vnia
抻	cwei
搽	caei
俪	lmui
铉	xcue
嚯	h/i
茁	vlei
韭	jlie
膘	byua
酩	mgei
榔	l;ei
娩	mfau
汗	hcoo
刎	wsua
扪	msei
漳	vpoo
仃	dtui
饬	cmua
壹	yiei
裨	bmoa
裨	pkoa
巽	xzae
黜	cni
滂	ppo
鹂	lkei
徉	y;uu
戕	qpa
埂	ggei
纫	rzaa
溉	gqoo
胛	jau
锌	xwue
遑	h;ui
跻	jiia
蒿	hy
钛	tque
岷	msia
葩	pqei
磺	h;eu
汕	scoo
肛	gpua
涿	vooo
鲛	jyua
睥	bmi
滦	lfoo
稔	rsue
锲	qxu
徜	c;uu
冼	xfoe
獐	vpua
喙	hxia
讧	h/oa
氨	rru
褓	bhoa
赊	sei
菀	wfei
鄱	plu
炅	gxia
碜	cseu
戗	qpuo
瓴	lguo
酊	dgei
钠	nqu
镌	jrue
铀	ylue
羯	jdou
挝	woe
襁	q;o
渚	vjoo
胫	jvua
雎	jui
砥	dkeu
衢	qju
狒	fxua
骞	qroo
荟	hxei
华	haui
号	hbia
正	vtei
石	dceu
汛	xzoo
色	saua
盥	gcui
睚	yaia
栎	lmei
砣	tleu
烩	hxou
夯	hpeu
拮	jdei
驷	smaa
殓	lce
哔	bmia
徇	xzuu
蹴	cnia
忾	kqoo
疹	vsoe
鸵	tlua
韫	yzee
祛	quo
膻	srua
黢	quia
仄	fxeu
唳	lmi
烊	y;ou
烊	ypou
孀	spau
腚	dvua
牍	djui
佃	dcui
赡	sci
秣	m/ue
榷	qxei
镭	ldue
铄	s/ue
嫒	rqau
饽	boua
谌	csoa
啮	nxia
蝼	llia
闱	wdoi
篙	gyue
逡	qwa
膑	bzua
隍	h;a
罄	qve
蕨	jdei
呢	nki
囵	lsia
橹	ljei
睢	seia
喱	lki
肓	hpoe
榈	ljei
绶	s/a
槊	s/ou
罹	lkia
槁	ghe
秸	jeue
裱	bhoa
牦	mhue
滓	fkoo
腓	fdua
砝	faeu
舐	smue
谶	czoa
秆	gfue
荏	rse
斛	hjua
暨	jmae
滟	ycoo
纾	suaa
粑	bqou
诳	k;o
寮	lhoo
鹑	csoe
驽	njau
囫	hjia
徕	lau
弭	mkae
橇	qye
痢	lmoe
圜	hfia
撺	crei
柑	grei
儆	jgu
魉	l;ui
妊	rzau
氏	viua
酶	mdei
庖	phoe
缢	ymaa
俎	fjuo
鲫	jmua
藓	xfei
佰	bau
痔	vmoe
觥	goua
哞	moi
伉	kpui
怄	r/o
轱	guea
泵	bveu
擀	gfei
蝌	keia
绌	cna
蓑	soei
釉	y/uo
翳	ymea
讫	qmoa
蜇	veei
蜇	vdei
砧	vweu
殄	tfeu
萼	rxei
胰	ykua
蜍	cjia
瘀	yuoe
鸪	guei
霰	xceo
鹧	vxoe
诨	hzoa
僭	jcui
弁	bcao
湎	mfoo
栉	jdei
蹉	coi
醍	tkei
磬	qvei
泷	lloo
蓼	lhei
铂	blue
梏	gnei
鸩	vzo
豌	wre
嘬	foia
疡	y;oe
荞	qhei
涝	lboo
蛔	hdia
焖	mzou
祉	vko
魍	w;ui
跎	tlia
锉	c/ue
桎	vmei
喆	vdei
娠	swau
诿	wdoa
瓯	roea
殚	dreu
镁	mdue
痂	jqoe
胱	gpua
刍	cjua
醐	hjei
糅	rlou
愎	bmoo
赝	yceu
唁	ycia
笳	jque
崂	lhia
踽	jjia
鳍	qkua
帧	vwia
骈	pfa
仟	qrui
羸	ldo
谪	vdoa
狲	swua
槃	pfuu
珲	heee
蛭	vmia
痍	ykoe
猢	hjua
鼹	yfui
悌	tmoo
莅	lmei
咩	mei
誊	tgou
鳝	scua
韪	wdia
噱	jdia
俚	lkui
硌	gxeu
脍	kqua
汞	glei
淖	nbo
姘	pwa
聩	kxei
泅	qloo
喑	ywia
绦	dkaa
铡	vaue
恽	yzoo
遒	qlou
痨	lhoe
蚪	dlia
蒺	jkei
觞	spua
葺	qmei
煅	dcou
悱	fdoo
茕	qlei
靛	dcee
诓	kpoa
箔	blue
珥	rkee
岬	jaia
臬	nxu
肱	goua
焙	bxou
鸷	vmei
蜢	mgia
莠	ylei
铨	qfue
胺	rcu
堇	jsei
嶂	vpia
钾	jaue
跹	xria
鹌	rreu
笞	ciue
缛	rna
椽	cfei
苕	thei
酮	tlei
婺	wnao
貉	hduo
囿	y/i
铣	xkue
舂	coee
碘	dfeu
馔	vcua
铢	vuue
涪	fjoo
氯	lnue
傣	daui
度	dloe
篾	mxue
猕	mku
砒	pieu
颛	vria
柒	qioo
饴	ykua
圩	wdei
疱	pboe
圄	yjia
枸	glei
貅	xouo
蛎	lmia
唢	sli
窠	keoo
囹	lgia
撷	xdei
伥	cpui
疟	nxoe
傩	nlui
诟	g/o
嗞	fiia
赅	gqia
楂	vqei
氮	dcue
竽	yjue
碣	jdeu
谔	rxoa
铧	haue
铆	mhue
滁	cjo
遴	lsou
舛	cfua
荠	jmei
稞	keu
阄	joo
荚	jaei
媪	rhau
悒	ymoo
笏	hnu
晷	gdia
宥	y/oo
豸	vmuo
摈	bzei
凫	fjua
阡	qra
粕	p/o
癣	xfoe
珐	fqee
馏	llua
龈	ysie
锒	l;ue
虻	mgia
腩	nfua
吖	rqia
瓤	r;o
楫	jkei
镊	nxue
阆	lpoi
豕	skeu
擘	b/a
玎	dtee
馐	xoua
潍	wdoo
龅	byie
黩	djia
芪	qkei
砭	breu
腱	jcua
挈	qxee
怼	dxao
嬗	scau
貔	pkuo
杷	paei
讴	roo
铬	gxue
沆	hpoo
蝮	fnia
烷	wfou
箜	kou
揿	qze
茴	hdei
鲈	ljua
昴	mhia
缟	gha
瘙	sbo
痫	xfoe
矾	ffeu
氖	naue
烯	xiou
铰	jhue
妯	vlau
耄	mbei
搦	n/ei
飨	x;aa
鳏	grua
痼	gnoe
讣	fnoa
馕	n;u
鲇	nfua
妁	s/au
垩	rxei
枇	pkei
幂	mmoa
蟊	mhao
萁	qkei
鹳	gce
盱	xuia
帑	t;a
侪	caui
娌	lkau
煸	bro
孳	fiou
蚋	rxia
脔	lfoe
箬	r/ue
樯	q;ei
趸	dse
苣	jnei
萸	yjei
謇	jfoo
妣	bka
啁	voia
氰	qgu
蒹	jrei
莴	woei
夤	ysua
鹬	ynao
腭	rxua
鲑	geua
淦	gcoo
鲠	ggu
蚝	hhia
瀣	xxoo
骐	qkaa
堀	kuei
柞	f/ei
泔	groo
锰	mgue
蟥	h;ia
薅	hye
嵯	clia
蛳	siia
篦	bmue
荜	bmei
焯	cyou
芡	qcei
螯	rhee
眙	ykia
肄	ymua
荨	qfei
耋	ddei
俳	paui
铱	yiue
薮	slei
笄	jiue
渑	mfoo
豉	ckei
疣	yloe
镍	nxue
轳	ljea
熵	spou
瘆	szoe
杼	vnei
诂	gjo
鲶	nfua
氟	fjue
洄	hdoo
孢	byai
郴	cwei
詈	lmia
鞣	rlei
蜉	fjia
耦	rlee
蛉	lgia
箪	drue
愆	qruu
藿	h/ei
痱	fxoe
纡	yua
葚	szei
黧	lkue
毖	bmea
髋	kri
坻	dkei
蜊	lkia
铙	nhue
漯	tqoo
骟	scaa
捌	bqei
椴	dcei
墒	spei
溘	kxoo
牖	ylui
蹚	tpi
阋	xmo
龋	qjie
刈	ymuo
悭	qroo
蠲	jrou
瓠	hneu
圪	geei
轾	vmea
麸	fuee
锱	fiu
瞽	gjei
糍	ckou
蹼	pjia
鳕	xdua
偬	flui
榫	ssei
秭	fku
瘢	broe
殍	pheu
碇	dve
碓	dxe
孓	jdai
痧	sqoe
痈	yooe
埚	goei
壅	yooe
怙	hnoo
癔	ymoe
潆	ygoo
檩	lsei
痤	cloe
嘚	deia
菽	suei
茭	jyei
酰	xrei
菏	hdei
诹	foo
粳	jtou
糌	fro
舸	gduu
趵	bbia
枥	lmei
膈	gdua
傧	bwu
鸬	ljie
艿	nae
酚	fwei
椟	djei
氦	hque
笸	plue
疸	dfo
醛	qfei
篌	hlue
枳	vkei
酯	vkei
髫	thei
缳	hfaa
孥	njau
溧	lmoo
镬	h/ue
卺	jsai
皴	cwao
鍪	mlao
坩	grei
砻	lleu
郯	tfou
筚	bmue
跬	kdia
醚	mke
蚧	jxi
肽	tqua
绀	gcaa
顸	hree
谵	vroa
鲟	xsua
屣	xkae
鹚	ckou
焗	jjou
疖	jeo
炝	qpou
啉	lsia
硒	xieu
伛	yjui
蛄	guia
燹	xfeu
缫	syaa
髀	bmia
凇	sooe
鼙	pkei
悛	qroo
轫	rzea
苷	grei
羝	diou
蘖	nxei
蚍	pkia
桡	rhei
耨	n/ee
搴	qroo
榧	fdei
蚜	yaia
轭	rxea
皲	jwoa
胝	viua
蝣	ylia
鲋	fnua
硼	pgeu
葸	xkei
溏	t;oo
鲱	feu
溽	rnoo
滏	fjoo
彖	tca
耜	smee
嫠	lkee
锂	lkue
劬	qjua
颟	mr
曈	tlia
濞	bmoo
郫	pkui
怍	f/oo
螨	mfia
阈	ynoi
肫	vwua
蝰	kdia
蝓	yjia
暌	kdia
蒌	llei
颞	nxei
鲷	dyua
囟	xzui
溴	x/oo
畚	bsa
癜	dcoe
辊	gse
嘌	pyi
烃	ttou
柽	ctei
秕	bkue
豇	jpeo
蛞	k/ia
颃	h;oe
骶	dkia
鳔	bbua
髂	qqi
瘘	l/oe
胗	vwua
髌	bzi
楦	xcei
籼	xrou
齁	hou
骒	kxa
堙	ywei
袪	quoa
酞	tqei
鲻	fiua
氪	kxue
去q	qnei
起q[	qkei
前q]	qfou
我w	wlue
为w[	wxou
无w]	wjee
他t	tqui
她t[	tqau
天t]	tree
一y	yiee
有y[	yleu
也y]	ydai
是s	smia
说s[	sxoa
上s]	spie
人r	rsuo
然r[	rfua
而r]	rkeu
的d	dmui
得d[	dduu
地d]	dmei
在f	fqeu
自f[	fmui
发f]	fqau
个g	gxuo
过g[	g/ei
更g]	gtei
会h[	kquo
好h	hbau
还h]	hfeu
将j[	jpoe
就j	j/oe
间j]	jcoi
可k	kdei
看k[	krue
空k]	k/oo
了l	leai
来l]	laeo
里l[	lkia
下x	xqei
心x[	xwoa
小x]	xhiu
成c[	cgeu
出c	cuai
从c]	cluo
这v	vxoe
中v[	v/ia
只v]	vkia
不b	bneu
把b[	bqei
被b]	bxoa
你n	nkui
能n[	ngao
那n]	nqae
没m	m/oo
吗m[	mqia
明m]	mgia
到p	dbea
大p[	dqeu
都p]	duei
