让	w,
我	w
若	w.
是	s
说	s.
事	s,
的	d
到	d.
对	d,
有	f
也	f.
要	f,
用	y
又	y.
与	y,
过	g
给	g.
更	g,
他	t,
她	t.
它	t
这	z
着	z.
真	z,
去	q
却	q.
全	q,
和	h.
好	h,
还	h
将	j.
就	j
即	j,
可	k
看	k.
快	k,
了	l
来	l,
两	l.
不	b
把	b.
被	b,
你	n
能	n.
呢	n,
没	m
吗	m.
每	m,
想	x
向	x.
像	x,
次	c.
才	c,
从	c
在	r
最	r.
再	r,
都	p
当	p.
但	p,
