去	q
却	q[
全	q]
让	w]
我	w
若	w[
在	z
最	z[
再	z]
他	t]
她	t[
它	t
用	y
又	y[
与	y]
都	p
当	p[
但	p]
是	s
说	s[
事	s]
时	r
使	r[
事	r]
的	d
到	d[
对	d]
有	f
也	f[
要	f]
过	g
给	g[
更	g]
和	h[
好	h]
还	h
将	j[
就	j
即	j]
可	k
看	k[
快	k]
了	l
来	l]
两	l[
想	x
向	x[
像	x]
次	c[
才	c]
从	c
这	v
着	v[
真	v]
不	b
把	b[
被	b]
你	n
能	n[
呢	n]
没	m
吗	m[
每	m]
一	yi
人	rh
个	gx
上	sc
大	d/
们	my
道	dv
那	n/
么	me
地	dm
子	zk
下	x/
出	cu
中	vo
中	vq
然	rs
里	lk
为	wd
为	wx
自	zm
得	de
得	dd
会	hx
天	tw
心	xy
后	hq
以	yk
小	xg
起	qk
之	vi
手	sl
而	nd
只	vii
只	vk
生	s;
身	sy
头	tl
样	yc
多	do
己	jk
家	j/
面	mz
知	viu
开	kr
如	rj
无	wj
现	xz
很	hh
点	ds
前	qs
发	f/
经	j;
情	qp
老	lg
些	xe
话	h/
已	yka
声	s;e
意	ym
于	yj
回	hd
笑	xv
所	rl
眼	ys
成	cp
方	fr
年	ns
见	jz
女	nj
力	lm
气	qm
长	cf
长	vf
动	dq
间	jw
间	jzo
国	gl
走	zl
正	v;
问	wb
打	da
明	mp
儿	ndu
法	fa
几	jku
行	hf
行	xp
三	rw
定	d;
此	ck
进	jb
种	vl
实	sk
同	tli
本	bh
分	fy
十	ske
学	xd
高	gt
第	dmu
感	gs
怎	zh
神	sh
听	t;
边	bw
作	zq
其	qke
吧	b/
口	kl
觉	jd
啊	n/i
因	yy
白	bf
军	jy
做	zqu
外	wc
门	mh
光	gr
风	f;
主	vj
住	vn
果	gli
二	nx
候	hqu
公	go
相	xr
相	xc
等	dp
别	bd
色	rx
死	rk
张	vr
部	bn
太	tc
日	rm
少	sg
少	sv
战	vz
理	lke
直	vke
重	cl
重	vqu
王	wf
脸	ls
比	bk
何	hdu
水	sd
名	mpu
体	tk
东	doe
叫	jv
西	xi
应	y;
便	bz
便	ps
放	fc
马	ma
难	nsa
轻	q;
美	md
位	wxu
关	gw
机	ji
接	je
先	xw
文	wh
处	cj
处	cn
并	b;
望	wco
常	cfi
完	ws
四	rmi
飞	fe
师	si
者	vd
安	nw
清	q;o
刚	gri
跟	gy
月	yx
信	xb
山	sw
爱	nc
内	nxi
龙	ll
空	ko
空	kq
带	dc
找	vg
原	yse
入	rn
李	lkei
连	lse
吃	ci
场	cfe
平	pp
思	ri
林	lh
变	bzo
什	shu
由	yl
受	sq
亲	qy
命	m;
目	mn
强	qf
男	nsi
任	rb
该	gro
路	ln
车	ce
今	jyu
海	hfo
加	j/a
远	ysee
活	hl
特	tx
解	jdu
电	dz
世	sm
性	x;
表	bg
许	xj
立	lmo
黑	he
金	jyuo
红	hla
花	h/e
转	vs
转	vze
总	zlo
算	rz
城	cpe
队	dx
孩	hfa
反	fs
工	goe
始	ska
满	ms
新	xyo
兵	b;u
物	wn
离	lko
非	fei
虽	re
云	yh
似	rmu
万	wz
至	vm
干	gwe
干	gz
通	to
认	rbo
失	siu
火	hlo
哥	ge
士	sme
五	wje
惊	j;o
魔	ml
竟	j;oe
姐	jda
乎	hu
剑	jzu
往	wfu
量	lf
量	lc
早	zg
结	jdaa
怕	p/
流	llo
突	tu
坐	zquo
斯	rie
音	yyo
紧	jh
指	vkei
拉	l/
杀	s/
半	bzou
记	jm
且	qd
利	lmu
合	hduo
倒	dg
倒	dvu
书	su
度	dn
微	we
步	bni
教	jt
教	jve
喜	xk
越	yxe
影	yp
谁	sdo
冷	lp
深	syo
告	gv
落	lq
象	xcu
容	rlo
怪	gc
传	cs
传	vzu
钱	qsu
提	tke
言	yso
随	rd
双	sr
服	fj
击	jie
武	wjee
哪	na
数	sj
数	sn
站	vzo
奇	qkeu
房	ff
管	gsu
灵	lpa
刻	kx
题	tki
衣	yio
周	vou
静	j;e
伤	sru
百	bfe
拿	nau
妈	m/
办	bza
星	x;i
化	h/u
功	goei
绝	jdaa
系	xm
般	bwu
必	bm
业	yxi
尔	ndua
件	jzui
血	xdu
血	xx
代	dcu
精	j;ou
弟	dmo
终	voa
近	jbu
条	tg
青	q;e
界	jx
司	ria
整	vp
欢	hw
字	zmo
晚	wsi
民	mha
帮	br
切	qe
切	qx
忙	mf
交	jto
或	hqe
暗	nz
夫	fu
员	ysi
根	gye
石	skeu
哈	h/i
夜	yxo
父	fn
制	vmu
友	yle
阿	n/a
息	xiu
冲	co
酒	jl
保	bgu
片	pz
形	xpe
阵	vb
南	nse
决	jdo
请	qpo
各	gxu
报	bv
兴	x;o
阳	yf
急	jkua
语	yjo
令	l;
错	cq
及	jka
刘	lloe
极	jke
识	sko
备	bx
慢	mzo
雪	xde
苦	kj
领	lpu
收	so
底	dk
尽	jba
准	vh
华	ha
华	h/ui
答	dau
众	vquo
千	qw
消	xt
视	smo
罗	lli
敢	gsa
留	llu
克	kxe
乐	lx
乐	yxu
够	gq
跑	pg
显	xs
嘴	zd
官	gwo
断	dzo
未	wxe
势	smei
句	jn
求	ql
计	jmo
论	lb
达	dae
则	zdi
害	hc
八	b/u
单	dw
久	jlu
脚	jg
德	ddu
元	ysee
脑	ng
楚	cje
雨	yje
睛	j;i
响	xf
刀	dt
确	qxe
玉	yn
得	dduu
沉	ch
北	bdi
格	gd
停	tp
陈	cha
市	smoe
朝	vt
朝	cg
喝	hei
族	zj
江	jr
团	ts
母	mj
章	vro
装	vroe
亮	lco
客	kxo
照	vv
乱	lz
易	ymi
足	zji
依	yiu
黄	hfe
修	xo
破	pq
台	tf
球	qle
呀	y/
院	yz
送	rq
包	bt
义	ymo
诉	rno
攻	goei
丝	riaa
围	wdi
玩	wse
待	dr
待	dcuu
复	fnu
况	kc
楼	lle
丽	lme
痛	tq
梦	m;e
呼	hui
摇	yg
期	qkei
英	y;e
低	di
帝	dmoe
兄	xoi
背	be
背	bxi
持	cke
爷	yd
皇	hfu
七	qi
六	lqo
穿	cw
杨	yfe
政	v;e
运	yb
居	ju
叶	yxia
热	rxe
校	jvei
校	xve
谢	xxo
曾	cpo
古	gj
细	xma
产	cso
睡	sx
希	xiuo
速	rne
室	smoo
旁	pf
另	l;i
怀	hfoo
露	lne
异	yma
写	xdo
鬼	gdu
娘	nf
取	qj
式	smea
除	cja
级	jkaa
考	kg
建	jza
愿	yze
招	vte
饭	fz
布	bne
续	xn
程	cpu
首	slo
观	gwa
朋	ppu
务	wnu
掉	dve
赶	gse
忽	huu
注	vno
术	sne
甚	sb
差	c/
呵	heia
展	vsa
争	v;u
品	ph
兰	lso
宝	bgo
香	xru
斗	dqo
故	gn
雷	ld
念	nzu
段	dzu
顿	db
角	jgu
角	jdua
疑	yku
护	hn
闪	ss
木	mne
需	xu
调	dvo
调	tgo
类	lxo
妹	mx
爸	b/uo
线	xza
左	zle
游	ylo
派	pc
谈	tso
激	jio
冰	b;o
敌	dku
跳	tv
支	vie
约	ye
巴	b/a
您	nh
顾	gne
肯	kh
醒	xpei
铁	td
抱	bve
淡	dzoo
造	zv
伙	hlu
资	zi
群	qh
集	jkui
联	lsei
商	sro
号	hg
号	hv
节	jde
讲	jf
掌	vfi
赵	vve
密	mm
九	jlua
病	b;oe
卫	wxa
米	mk
威	wee
继	jma
渐	jzoo
统	tla
追	ve
亚	y/e
简	js
练	lza
基	jiei
选	xsu
推	te
改	gf
退	txa
味	wxi
份	fb
举	jj
示	smee
忍	rha
历	lmeu
器	qmi
恐	kle
引	yha
试	smoa
皮	pk
习	xka
靠	kv
导	dga
存	che
莫	mq
志	vme
区	qu
汉	hz
右	yq
严	ysei
态	tce
买	mfa
幸	x;e
社	sxo
佛	fl
佛	fju
议	ymoa
树	snei
止	vki
块	kce
守	sloo
毛	mg
挥	hee
胡	hj
散	rse
散	rze
板	bs
仅	jhu
隐	yhai
怒	nn
床	cfo
苏	ru
料	lv
股	gju
局	jja
班	bwe
图	tj
岁	rxi
礼	lkoa
独	dj
初	cuo
福	fjo
顺	sbu
狂	kf
默	mqi
巨	jne
既	jmae
松	ro
证	v;o
烈	lxe
否	fle
恶	nde
恶	nxe
恶	wne
治	vmo
缓	hs
排	pfe
费	fx
拍	pr
耳	ndei
医	yie
寒	hso
哭	ku
温	wy
府	fjoe
担	dwe
担	dze
称	cb
称	c;
余	yju
钟	voue
泪	lxoo
烟	yw
仍	rp
具	jni
忘	wcoe
恩	ny
毕	bme
警	jp
蓝	lsei
宫	goo
吸	xii
陆	lna
究	jo
抓	v/
压	y/eu
沙	s/o
救	jq
呆	dri
河	hdo
迷	mko
枪	qr
组	zja
权	qse
叹	tz
孙	ry
卷	jso
查	ca
毫	hgo
春	cy
察	cao
圣	s;a
草	cge
较	jvea
胜	s;u
遇	yni
充	coo
史	ski
堂	tfi
防	ffa
据	jnei
猛	mpua
骑	qka
土	tje
卡	ka
助	vni
京	j;oe
银	yhu
贵	gxi
永	yloa
质	vmuu
屋	wu
须	xuu
副	fne
换	hze
刺	cm
属	sja
闻	who
境	j;ei
禁	jye
禁	jbe
阴	yya
共	gqe
负	fnua
弄	nq
翻	fw
虎	hji
层	cpa
喊	hsi
逃	tgu
晓	xgi
座	zqo
雅	ya
参	cwa
射	sxu
婚	hy
险	xsa
君	jya
划	h/ea
坚	jwi
价	j/u
柔	rla
超	ct
扬	yfei
科	ke
按	nze
狠	hhu
野	ydi
秦	qhe
秘	mmu
熟	sloe
熟	sjo
置	vmi
仙	xwu
模	mle
模	mje
伸	syu
波	bo
肉	rqi
假	ja
假	j/ui
齐	qko
舞	wju
脱	tou
广	gfo
姑	gu
麻	mao
投	tle
顶	dpe
致	vmea
责	zde
景	jpi
营	ype
维	wda
设	sxoa
坏	hce
啦	l/i
秀	xq
败	bc
眉	mda
州	voo
药	yv
承	cpai
案	nzo
狼	lfu
专	vw
偷	toui
画	h/ei
吴	wji
店	dzoe
哦	nqi
弹	dza
弹	tsa
食	sku
欲	ynu
抬	tfe
标	bte
秋	qo
厉	lmeu
良	lfo
际	jmai
状	vc
烦	fso
午	wjue
摆	bfei
戏	xmao
桌	voi
船	csu
短	dsu
村	cye
某	mlei
摸	mo
付	fnui
演	ysoo
规	gee
萧	xte
封	f;e
握	wq
田	tsi
唐	tfo
藏	cfei
震	vbe
混	hho
混	hb
虚	xui
透	tqu
纪	jmaa
凌	lpo
休	xou
嘛	m/i
梅	mde
紫	zki
歌	geei
临	lhi
毒	dje
宗	zo
著	vne
索	rle
印	ybu
寻	xh
湖	hjo
劲	jbao
职	vkei
技	jme
恨	hbo
婆	pl
杰	jdei
羽	yja
咱	zs
素	rnee
凡	fsu
值	vku
飘	pt
养	yfo
嘿	heia
普	pj
宁	np
宁	n;
吓	x/i
兽	sqo
夏	x/e
读	djo
街	jeu
牛	nl
仿	ffu
胸	xoua
浪	lcoo
富	fno
尚	sci
宇	yjoo
骨	gji
智	vmue
纷	fya
升	s;ue
叔	sui
善	sz
弱	rqa
架	j/au
卖	mc
袋	dcui
网	wfi
朱	vu
骂	m/ia
雄	xl
赛	rc
略	lxi
杯	bee
施	sio
墙	qfe
环	hse
罪	zx
牙	yae
窗	cr
柳	llei
厅	t;e
搞	gg
端	dwo
洞	dqoo
适	smu
拥	yo
释	smuo
洋	yfoo
肩	jwo
魂	hhe
闹	nv
蒙	m;ei
蒙	mpe
洗	xko
灯	d;o
借	jxu
伯	bl
免	msu
菜	cc
验	yza
凤	f;u
鱼	yjua
徐	xju
型	xpee
娜	n/au
娜	nla
暴	bvi
亡	wfo
讨	tgoa
辈	bxie
懂	dl
腿	tdu
灭	mxe
妙	mv
效	xvo
危	weu
优	you
盘	psu
套	tve
丁	d;e
趣	qn
妖	yt
束	snei
杂	za
诗	sioa
迎	ypu
舍	sdu
旧	jqi
彩	cfu
委	wdu
挂	g/
笔	bku
狗	glu
鲜	xwua
鲜	xsua
纸	vka
抗	kcei
探	tze
韩	hsei
尼	nk
控	kqe
惜	xkoo
珠	vue
抽	coe
创	cru
创	ccu
归	gei
挺	tpe
奋	fbe
陪	pd
硬	y;eu
避	bma
园	ysia
托	toe
训	xbo
勇	yla
聊	lge
种	vque
奶	nfa
庄	vroe
奔	by
奔	bb
镇	vbu
拳	qso
采	cfuo
研	yseu
配	px
介	jxuo
尊	zy
冒	mvi
虑	lni
敬	j;ei
丹	dwu
舒	suu
蛋	dzai
哼	h;
宋	rqo
济	jmoo
妇	fna
箭	jzue
择	vfe
择	zdei
犯	fzu
欣	xyu
甲	jai
欧	no
课	kxoa
扑	pu
菲	fee
菲	fd
燕	yzei
曲	qui
曲	qji
躲	dlu
玄	xso
幻	hza
茶	cae
折	vde
折	sde
伊	yiui
傻	sa
姓	x;a
源	ysoo
洛	lqoo
遍	bzoa
臣	chei
弃	qmo
犹	ylu
占	vwi
占	vzi
漂	pto
漂	pgo
漂	pv
挑	tt
挑	tge
获	hqei
绿	lnaa
峰	f;i
俊	jbui
疯	f;o
列	lxeu
作	zou
森	rye
妻	qie
恋	lzo
误	wno
拜	bcu
伟	wdui
移	ykue
纳	n/aa
党	df
罢	b/i
腰	ytu
巧	qg
孤	gua
闭	bmo
圆	ysia
碰	p;
镜	j;u
软	rsea
厚	hqeu
累	ldi
累	lxia
昨	zli
幽	yoi
悲	bei
丈	vce
牌	pfu
降	jc
降	xfa
颜	ysoe
劳	lgei
偏	pw
省	sp
省	xpi
糊	hjou
糊	hno
馆	gsua
烧	st
谓	wxo
财	cfia
舰	jzuu
汗	hsoo
汗	hzo
奈	nce
操	cte
迹	jmoe
尸	sia
悄	qgo
残	cse
尖	jwiu
鲁	lj
锋	f;ue
圈	jzi
圈	qwi
油	yloo
俩	la
项	xce
撞	vcei
瞬	sbi
忆	ymoo
盖	gco
尤	yleu
徒	tju
乡	xra
概	gce
户	hnoa
荡	dce
艺	yme
增	z;
祖	zjo
困	kb
殿	dzae
迅	xba
横	hp
横	h;e
范	fze
律	lnu
番	fwu
企	qku
惨	csoo
限	xzai
聚	jnei
含	hsu
凭	ppui
剧	jna
碎	rxeu
躺	tfu
缘	ysa
凉	lfoe
腾	tpu
织	via
抢	qre
抢	qfei
预	yna
沈	sho
替	tm
孔	kla
批	pi
康	kro
惑	hqea
唯	wdia
率	lno
惯	gzo
登	d;a
互	hne
盯	d;i
稍	stu
宣	xwo
唱	cci
诚	cpoa
剩	s;ue
咬	ygi
育	yno
诸	vuo
触	cnu
晨	chi
策	cx
疼	tpo
漫	mzoo
材	cfei
补	bj
私	riu
吐	tji
吐	tn
纯	chaa
艾	ncei
贝	bxia
谷	gjuo
庭	tpoe
挡	dfe
晃	hfi
晃	hci
吉	jkei
吹	cei
仔	zf
仇	clu
凝	npo
鼓	gje
农	nlo
席	xkoe
征	v;uu
帅	sciu
附	fnai
缺	qeu
塞	rr
塞	rco
塞	rxo
豪	hgoe
亦	ymoe
杜	dne
努	nja
判	pzo
谋	mlo
胆	dsua
尘	chiu
扎	v/e
滚	gh
闷	myo
闷	mb
迟	cka
稳	whu
翼	ymao
诺	nqo
闲	xsoi
灰	heeu
朵	dlua
盛	cpeu
盛	s;eu
梁	lfoo
晶	j;ia
餐	cwi
爆	bvo
伦	lhu
娇	jta
侧	cxu
愣	l;o
鼻	bkui
轮	lhe
昏	hyu
抖	dle
陷	xzai
敏	mhu
词	cko
慌	hr
愤	fbo
怜	lsoo
颤	cz
阶	jea
苍	cre
距	jnia
郑	v;ou
川	cwu
扫	rg
扫	rv
逼	bi
县	xzi
忧	yoo
童	tlo
执	vkei
丢	dou
荣	rlei
臂	bmae
逐	vje
傲	nvu
戴	dcei
芒	mfe
庆	q;oe
伴	bzu
袭	xke
供	gou
供	gqu
积	jiu
测	cxo
遥	ygu
阻	zjai
例	lmui
睁	v;i
岛	dgu
遗	yki
瞪	d;ia
慕	mnei
皱	vqua
博	ble
幕	mnei
猜	crua
益	ymou
净	j;oe
泽	zdo
炼	lzou
监	jwii
鸡	jia
珍	vy
伏	fjui
绍	sva
曹	cgei
爬	pa
丫	y/o
炸	va
炸	v/o
壁	bmae
涌	yloo
凶	xouo
郎	lfoa
宿	rnoo
宿	xlo
宿	xqo
怨	yzu
醉	zxe
拼	py
迫	pqu
革	gde
瞧	qgi
奥	nvui
输	sue
莉	lmei
忠	voia
颗	kei
嗯	nyi
佳	j/ui
旅	ljo
仁	rhu
鸟	ngu
骗	pza
浩	hvo
塔	ta
胖	pcu
绪	xna
枫	f;ei
拔	ba
赞	zz
炮	pvo
傅	fnui
凯	kfi
邪	xdea
芳	fre
浑	hhoo
夺	dleu
宽	kw
堆	dee
裂	lxeu
遭	zt
赤	cme
旋	xsoe
旋	xzo
扭	nle
洁	jdoo
浮	fjoo
悉	xiuo
难	nza
擦	c/e
慧	hxe
典	dsi
赏	sf
匆	cou
评	ppo
纵	zqa
莲	lsei
雾	wneo
乌	wuu
跃	yxia
壮	vco
贴	tei
丰	f;ee
隔	gda
健	jzui
辛	xyoe
抵	dke
竹	vju
彻	cxuu
摩	mloe
轰	ho
编	bwa
肚	dju
肚	dnu
插	c/ei
磨	mloe
磨	mqo
哎	nr
御	ynuu
耐	nceu
惧	jno
氏	smua
辉	heio
扶	fje
恢	heo
貌	mvu
额	ndo
述	snei
票	pve
录	lnae
拖	toei
膀	bfu
膀	pfua
鹰	y;o
孟	m;a
递	dmou
瑞	rxee
唇	cheu
暂	zze
货	hqui
琴	qhee
踪	zoi
码	mae
慰	wxae
蛇	sdi
玲	lpe
晕	yyi
晕	ybi
损	rhe
轩	xwe
粗	cuou
掩	ysei
屁	pm
悠	youi
仰	yfu
零	lpeo
盟	mpi
途	tjuo
贼	zdia
洪	hloo
悟	wnoo
固	gni
讶	y/oa
冬	doua
滑	hao
甜	tsu
郁	yne
琳	lhee
辆	lce
乃	nfau
猪	vuu
暖	nsia
妮	ni
挣	v;ei
旦	dzi
估	guu
坦	tse
甘	gwei
佩	pxu
莱	lfe
享	xfo
吼	hli
构	gqei
粉	fh
萨	r/
吻	whi
潜	qsoo
瓶	ppou
偶	nlu
戒	jxe
浓	nloo
毁	hdui
销	xtu
迪	dki
拒	jnei
绕	rva
勒	lxei
勒	le
朗	lfoa
嘻	xiia
尾	wdae
尾	ykae
帐	vci
废	fxo
延	ysu
敲	qt
烂	lzou
曼	mzi
厌	yzeu
宜	yko
羞	xoo
喂	wxia
吟	yhi
滴	dio
洲	vooo
爹	deu
艳	yzee
晴	qpi
抚	fjei
缩	roa
协	xdei
央	yr
悔	hdoo
肖	xti
肖	xvi
缠	csa
脆	cxua
痕	hhoe
伍	wjui
寂	jmoo
启	qkoa
翔	xfou
薄	bge
薄	blei
薄	bq
侯	hlui
劝	qz
郭	gooe
奴	njau
鸣	mpia
倾	q;u
彼	bkuu
扔	r;
撒	r/e
撒	ra
豫	ynao
检	jse
针	vyu
耀	yvi
痴	cio
姆	mja
篇	pwu
椅	yke
厂	cfeu
董	dlei
熊	xla
埋	mfei
乖	gru
狐	hju
蒋	jfe
踏	t/
隆	lla
括	kqei
潮	cgo
唉	nci
穷	qlo
聪	coei
唤	hzi
泰	tcee
版	bsu
末	mqe
旗	qkoe
仪	ykui
焦	jtu
猫	mt
盗	dvoe
侍	smui
挤	jkei
款	ks
拾	skei
荒	hre
强	qfa
姿	zio
域	ynei
搭	d/e
脉	mcu
脉	mqu
授	sqe
俗	rju
融	rlei
狱	ynua
欺	qiei
访	ffo
桥	qge
锁	rlu
霸	b/e
牵	qwe
池	ckoo
钻	zw
钻	zzu
港	gfoo
喃	nsia
廷	tpue
乘	cpue
玛	maee
奉	f;ee
扯	cd
岳	yxui
减	jsoe
弯	ww
夹	jae
辞	cku
岸	nzi
岂	qki
屈	qua
恼	ngo
哲	vdei
季	jmu
召	vva
丧	rre
丧	rce
尝	cfio
恭	goei
载	zfe
载	zc
瘦	sqoe
皆	jee
颇	po
茫	mfei
染	rso
肃	rna
爽	sfe
亏	kee
吞	ty
惹	rde
哀	nro
乔	qgu
趁	cbe
铺	puu
铺	pn
脏	zr
吕	lji
奖	jfo
倍	bxu
汤	tr
振	vbei
婷	tpa
牢	lgo
扰	rge
溜	lo
溜	lqoo
庞	pfo
臭	cqu
悦	yxoo
赫	hxei
赢	ypo
跪	gxia
麦	mce
枝	viei
侠	xa
泉	qsui
劫	jdei
炎	ysou
泥	nko
赌	dji
弓	goa
魏	wxue
罩	vvi
疾	jko
饰	smua
符	fjue
垂	cdu
映	y;i
漠	mqoo
脖	blu
饮	yhua
沿	ysoo
懒	lsoo
肤	fuu
桑	rra
堪	kwe
燃	rsou
卓	vli
祝	vnoa
赖	lcei
宾	byo
贾	jaei
喘	csi
焰	yzo
吵	cgi
冥	mpo
鞋	xdei
逸	ymu
均	jyei
库	kn
裤	kno
碗	wseu
航	hfuu
踢	ti
姨	ykau
酸	rwe
啸	xvia
龄	lpi
阁	gdo
舌	sdue
箱	xrue
冯	fp
邦	bre
钢	grue
霞	xae
促	cnui
泡	pvoo
盾	dbu
羊	yfou
碧	bmee
援	ysei
忌	jmae
结	jeaa
抹	mlei
抹	mqei
倩	qzu
锐	rxu
喷	pyi
拦	lsei
嘉	j/e
袖	xqoa
殊	sueu
辰	cheu
繁	fsue
络	lqa
抛	pte
嫁	j/au
咒	vqi
撤	cxe
键	jzue
湿	sioo
恰	q/
虫	cli
审	shoo
献	xze
媚	mxa
贤	xsi
葛	gdei
刹	s/u
刹	c/u
袁	ysei
摔	sre
序	xno
筑	vnu
斜	xduo
瓦	wa
涂	tjo
湾	wwo
莎	s/e
崇	clia
猎	lxu
刑	xpee
墨	mqia
娃	waa
梯	tie
桃	tgei
豆	dqe
驾	j/au
浅	qsoo
径	j;uu
饿	nxu
疲	pko
搬	bwei
瓜	g/u
莹	ypei
滋	zioo
润	rboo
铃	lpue
蛮	mso
蒂	dme
拨	boe
涛	tto
予	yjao
勾	goua
惠	hxei
析	xie
落	l/e
落	lve
砍	kse
撑	c;e
截	jdei
措	cqe
币	bmu
薇	weei
愈	ynuo
督	du
酷	kne
祥	xfoa
怖	bno
侵	qyu
岩	ysia
扮	bze
糟	zto
盈	ypa
腹	fnua
斩	vse
尺	ckae
签	qwu
稀	xiue
掏	tte
夸	k/
汽	qmoo
液	yxoo
姬	jiau
愧	kxoo
汇	hxo
柱	vnei
粮	lfou
堡	bgui
仗	vcu
笨	bbu
奏	zqe
歉	qzo
甩	sfu
怔	v;oo
允	yhao
竞	j;oe
祸	hqo
耶	yee
耶	yde
爵	jduo
绩	jmaa
诱	yqo
呜	wui
穴	xdoo
黎	lku
租	zu
培	pde
砸	zae
井	jpe
窝	wo
弥	mka
返	fsuu
匹	pke
啥	sai
凑	cqo
奸	jwa
陌	mqa
叛	pzou
核	hde
核	hje
卧	wqe
幅	fji
眨	vai
耗	hve
洒	rao
怡	ykoo
详	xfoa
卢	ljie
扣	kqei
哇	w/
丑	cla
勉	msua
孝	xvei
矛	mga
氛	fyu
衡	hpu
陶	tga
购	gqi
汪	wr
僵	jru
疗	lgoe
妃	fea
罚	fai
系	jmua
棋	qkei
缝	fpa
缝	f;a
咐	fni
躯	quu
泛	fzo
愁	clue
血	xxu
搜	roe
慈	ckou
肥	fdu
笼	llue
篮	lsu
俱	jnu
惟	wdo
柜	gxe
捉	voe
悬	xsia
霍	hqeo
泄	xxoo
咽	ywi
咽	yzi
齿	cki
秒	mgu
勤	qhei
扩	kqei
屏	bp
屏	ppa
霜	sreo
袍	pgoa
蝶	ddi
祭	jmua
夫	fjee
厨	cjeu
胁	xdua
璃	lkee
劈	pia
赚	vzia
锦	jhue
尬	g/e
尴	gweu
熙	xiei
寺	rme
昌	cri
贺	hxa
巾	jyi
描	mge
捕	bje
陵	lpai
咳	kd
扇	swo
扇	szo
虹	hlia
绵	msa
撕	riei
蔡	cce
催	ceu
彭	ppe
宠	clo
贪	twu
辱	rje
誓	smei
盒	hduo
寸	cbei
披	pie
搂	loe
搂	llei
饶	rgu
跌	dei
欠	qzua
肌	jiua
售	squ
巡	xha
抑	ymei
纹	wha
宏	hloo
幼	yqa
萍	ppei
驻	vna
丛	cluo
亿	ymui
播	boei
俄	ndui
刃	rba
蕾	lde
挨	nre
仲	vqui
迈	mcea
违	wde
辩	bzoe
埃	nrei
艘	rou
琪	qkee
灾	zro
僧	r;u
渡	dno
卑	beu
雕	dtu
鼠	sju
讯	xboa
辣	l/o
刷	s/a
艰	jwao
斥	cmu
裙	qho
翠	cxa
饱	bgua
掠	lxei
询	xho
勃	blei
夕	xku
矮	nfu
瑶	yge
赐	cmi
捏	ne
闯	cfoi
姚	yga
瑟	rxee
渴	kdo
谅	lcoa
昂	nfi
串	czi
沟	gooo
涉	sxoo
咕	gui
驶	skaa
摄	sxe
贫	phu
辕	ysea
婉	wsa
答	d/u
鹏	ppua
姜	jro
碍	nceu
荷	hdei
荷	hxei
冠	gwoa
冠	gzoa
魅	mxu
玫	mdee
裁	cfei
坡	poe
鸿	hloo
邓	d;ao
歪	wre
乏	fau
申	syi
割	geo
巫	wue
衫	swoa
棒	bce
阔	kqo
泣	qmoo
韦	wdee
恍	hfoo
贯	gza
魄	pqui
柄	bpe
患	hzia
覆	fnei
蜜	mmo
婴	y;ia
励	lmeu
锅	goue
陛	bmai
遮	veo
帕	p/i
咖	g/i
咖	k/i
嫌	xsau
胳	geu
挖	w/e
啪	p/ia
矿	kceu
凄	qio
爪	vgu
爪	vau
眠	msi
穆	mnu
啡	feia
吾	wjei
坛	tsei
脾	pku
恒	hpo
屠	tja
玻	boee
蓉	rlei
础	cjeu
曰	yei
耸	rluo
膊	blua
逆	nm
寿	sqee
驱	quaa
猴	hlua
佣	yqu
毅	ymoe
舅	jqu
铜	tlu
娟	jwau
眯	mki
淫	yho
吩	fyi
匪	fde
牧	mnue
役	ymuu
寄	jmoo
诡	gdoa
纤	xwa
腐	fjoe
姻	yyau
晰	xiia
渊	ywo
亭	tpoe
邀	ytui
哄	hoi
哄	hlia
骚	rt
墓	mnei
柯	keei
筋	jyue
崔	ceia
灿	czo
捷	jdei
淋	lho
弗	fja
辑	jkea
棍	gb
绳	spa
喝	hxi
频	phi
廊	lfoe
畏	wxia
歇	xei
裹	glo
苗	mgei
盼	pzi
咯	geia
咯	loi
咯	lqi
耍	sae
煞	s/ua
寝	qhoo
瞒	msia
添	two
嫂	rga
纠	joa
慨	kfo
嚷	rf
驰	ckaa
拐	gfe
宴	yzoo
津	jyo
岚	lsi
浴	ynoo
耻	ckei
挽	wsei
页	yxeu
誉	ynoo
牲	s;ue
乳	rjuo
仓	cruo
逝	smei
喉	hlia
逛	gcu
樱	y;ei
兼	jwou
戈	geea
哗	h/ia
哗	hai
会	kcu
涯	yao
捧	ppei
铭	mpue
障	vca
摊	twe
跨	k/ia
妥	tluo
揉	rlei
晋	jbei
寞	mqoo
寨	vcoo
漆	qioo
污	wuo
嘲	cgia
枚	mdei
吊	dvi
乾	qsei
馨	xye
伪	wdui
嗓	rfi
呈	cpi
卿	q;ua
楠	nsei
籍	jkue
裸	lloa
链	lzu
灌	gzoo
昆	ky
畅	ccia
逍	xtio
帽	mvia
阅	yxoi
逗	dqeo
蹲	dy
踩	cfia
窜	czoo
哑	yai
趴	p/ia
逢	fpu
植	vkei
媒	mdau
韵	ybo
昭	vti
尹	yhae
谦	qwo
档	dcei
趟	tre
趟	tcei
沾	vwo
兔	tnu
订	d;oa
朴	pje
瞎	x/ia
鞭	bwei
俺	nsu
斤	jyuu
翅	cmei
肠	cfua
雀	qti
雀	qgiu
雀	qxi
慎	sbo
盆	phuo
迁	qwue
镖	btu
芬	fye
崖	yaia
丘	qou
蠢	chee
庙	mvo
潘	pwo
颖	ypua
拓	tqe
娶	qje
纱	s/aa
漏	lqoo
谨	jho
珊	swe
仆	pju
曾	z;o
宙	vqo
尉	ynae
屑	xxa
叮	d;ia
捂	wjei
涩	rxoo
诧	c/o
柴	cfie
杆	gwei
杆	gsei
涵	hsoo
坠	vx
赔	pdi
涨	vfo
涨	vcoo
嘟	dui
崩	b;i
薛	xee
藤	tpei
税	sxue
枯	kue
译	ymoa
帘	lsoo
糖	tfou
愉	yjoo
骄	jtaa
羡	xzou
糕	gto
彬	bye
愚	yji
疏	sua
翰	hzei
堵	djei
腕	wzu
眸	mli
芸	yhe
溪	xio
殷	yyu
谎	hfoa
鼎	dpi
稿	ggu
哟	yoia
冤	ywoa
症	v;oe
棵	keei
狄	dkua
咧	ldia
湘	xro
宛	wso
嫩	nb
肆	rmei
宰	zfo
憾	hzoo
偿	cfui
腔	qru
哩	li
豹	bvu
瑰	geee
鉴	jzii
绑	bfa
潇	xto
戚	qieu
郡	jbae
澡	zgo
桂	gxei
兮	xiuo
雯	whe
颠	dwei
狮	siua
邻	lhuo
契	qme
骇	hca
卜	boi
卜	bji
差	cro
揭	jeei
妄	wcoe
坑	k;
伐	faui
矩	jju
烁	sqou
葬	zce
诀	jdoa
鄙	bki
鹿	lnoe
柏	bfei
柏	blei
溃	kxoo
朕	vbua
舟	vouu
妆	vroe
躁	zvi
霉	mdeo
侦	vyui
冻	dqoe
娅	y/a
庸	yooe
筹	clue
削	xtio
削	xeio
砰	p;e
耿	gp
牺	xiue
筒	tlue
遂	rxou
旭	xnu
胎	tru
惶	hfoo
淑	suo
叉	c/a
痒	yfoe
竖	sni
龟	geua
斑	bwee
儒	rjui
嫣	ywa
宅	vfoo
押	y/ei
胃	wxia
旨	vkua
册	cxua
膝	xiua
浸	jbo
弦	xsae
栏	lsei
衷	vooe
刮	g/ue
艇	tpuu
岗	gfi
赴	fnei
囊	nfe
斧	fjuo
颊	jaeo
疆	jra
炉	ljou
塌	t/e
乞	qkue
旺	wci
烤	kgo
黛	dcui
逊	xbai
贱	jzia
辨	bzoe
狸	lkua
叙	xnuo
愕	nxo
叠	dda
遣	qsi
晌	sfi
麟	lhoe
腥	x;u
粒	lmou
拟	nke
俏	qv
杖	vcei
芝	viei
夷	ykea
衬	cbo
佐	zlu
巷	xcei
捡	jsei
遵	zyo
塑	rnou
桶	tlei
泼	poo
滩	twoo
琼	qlee
昊	hvi
帆	fwi
搏	blei
颈	jpa
噢	noi
蹦	b;ia
寡	ga
贞	vyi
凰	hfua
哨	svi
拆	crei
茹	rjei
劣	lxiu
嘱	vji
沃	wqo
厢	xre
摘	vre
咋	v/i
咋	zai
咋	zdia
坤	kye
俯	fjui
媳	xkau
赋	fnia
嘶	rii
贡	gqei
碌	lneu
匙	ckia
拢	llei
谭	tsoa
翁	w;
辜	gue
竭	jdoe
廉	lsoe
械	xxe
贸	mvua
辅	fjea
讽	fpo
呐	n/ia
斌	byoe
辽	lga
填	tsei
窃	qxo
抄	ctei
溢	ymoo
妒	dna
吁	xuia
吁	ynia
嗦	roi
掀	xwei
芙	fjei
祈	qkoa
栋	dqei
吱	viia
撇	pe
撇	pdei
胞	btua
轿	jvea
禅	csoa
禅	szoa
妨	ffau
拂	fjei
倦	jzui
衰	sroe
靖	j;oe
循	xhu
挪	nlei
蓬	ppei
惩	cpuu
垃	l/ei
账	vcia
驳	bla
署	sji
甫	fjei
顽	wsee
姥	lgau
圾	jiei
熬	nge
枕	vhe
丐	gcei
茜	qze
咦	ykia
厕	cxeu
攀	pwe
彤	tlua
妍	ysau
拽	vcei
荆	j;ei
妓	jmau
壶	hjei
寇	kqoo
鹤	hxoa
钥	yvu
骤	vqa
渺	mgo
刊	kwee
肢	viua
烛	vjo
孕	yba
绽	vza
彦	yzoe
棉	mse
俘	fjui
盔	keeu
剪	jsou
诞	dzoa
兜	doui
凛	lhoe
岭	lpia
嚣	xtia
溅	jzoo
笛	dkue
舱	cruu
罕	hsoa
鸭	y/i
债	vcui
噬	smi
钉	d;u
躬	goui
倚	ykui
缕	lja
咚	doi
撼	hzei
蕊	rdei
侄	vkui
佑	yqui
雁	yzeu
隶	lma
践	jzia
拱	gle
沐	mno
菊	jje
蜂	f;ia
裕	ynoa
兆	vvu
搅	jge
尿	nva
黯	nzia
歹	dfeu
蓄	xne
朦	mpua
嘀	dkia
怯	qxoo
叨	dti
纽	nlaa
聘	pb
腻	nmu
剥	boa
彪	bti
沸	fxoo
氓	mpoe
卷	jzou
榜	bfei
榜	bcei
榜	p;ei
逻	llia
壳	kde
壳	qve
储	cju
憋	beo
啤	pki
匠	jce
悍	hzoo
昧	mxi
泊	blo
泊	pooo
篷	ppue
烫	tco
狡	jgua
轨	gdea
汹	xooo
携	xdei
磊	ldeu
隙	xmai
仑	lhuo
摧	cee
瞄	mgi
胧	llua
趋	que
挠	ngei
煌	hfou
擅	sze
卒	cno
卒	zjoe
饼	bpu
狭	xau
丸	wsu
惫	bxua
瞅	clia
卡	qa
犬	qseu
砖	vwe
矣	ykao
楞	l;e
昔	xiei
裳	sri
裳	cfio
骆	lqaa
雇	gno
阎	ysoi
骷	kui
鸦	y/ea
妞	noa
墅	snia
焚	fhe
谱	pjo
属	vja
绘	hxaa
梳	suei
肿	vlu
魁	kdu
耽	dwei
擒	qhei
陡	dla
璋	vree
茂	mve
蹄	tkia
瞥	peo
瞳	tlia
髅	llia
绣	xqa
硕	sqeu
肺	fxu
参	cya
参	sya
参	rwa
兹	ziou
炒	cgou
邮	yli
弘	hlae
嫉	jkau
届	jxa
嗡	w;i
娱	yjau
喧	xwi
脂	viua
膛	tfua
沧	croo
疚	jqo
盐	ysei
扁	bso
扁	pwoa
搁	geei
茅	mgei
滔	ttoo
坟	fhei
掐	q/e
瑜	yjee
邱	qoui
桐	tlei
茵	yye
苹	ppei
旷	kci
翘	qvea
郝	hge
蓦	mqei
诈	v/oa
沫	mqoo
菁	j;ei
粹	cxou
琢	vle
腊	l/u
钦	qyue
喻	ynia
宪	xzoo
锻	dzue
睹	djia
郊	jtoe
饥	jiua
侃	ksu
粘	vwou
媛	ysau
谊	ymoa
恳	kha
厮	rieu
锤	cdue
凳	d;ao
淮	hfoo
蔽	bmei
聂	nxei
贩	fzi
潭	tsoo
翩	pwoa
呻	syia
枉	wfe
拘	jue
煮	vjei
焉	ywe
址	vkei
匕	bkua
渗	sboo
览	lsii
敦	dyo
厦	s/eu
蕴	ybe
冉	rsi
薪	xyei
呃	nxia
峻	jbi
荐	jze
栽	zre
嚎	hgi
汁	vio
傍	bcui
秃	tuu
磕	keeu
禀	bpo
珑	llee
坎	ksei
邵	svau
萌	mpei
窄	vfoo
阮	rsa
蹈	dgi
碑	beeu
婶	sha
煤	mdo
寓	ynoo
栈	vzei
滞	vmoo
倘	tfui
杭	hfei
暇	xai
藏	zcei
狈	bxua
峡	xaia
侣	lju
芦	lje
蔓	mze
蒸	v;ei
禄	lnoa
胀	vcua
醋	cne
淌	tfoo
伞	rsu
姊	zka
钩	goue
衍	ysuu
妾	qxoe
嘎	gai
蜀	sjia
蝴	hjia
萝	llei
莽	mfei
弩	njau
祷	dgo
稚	vmue
圳	vbei
徽	heu
衙	yau
咸	xse
陋	lqai
奢	se
罐	gzu
霄	xteo
毙	bmea
汝	rjo
敞	cfio
暮	mnei
嘘	xuia
灼	vlo
澜	lsoo
姗	swa
倪	nku
挫	cqei
咪	mi
钧	jyue
捣	dge
燥	zvo
泳	yloo
眶	kcia
乙	ykaa
澈	cxoo
焕	hzou
酬	cle
筷	kcue
宵	xtoo
揪	joe
缚	fnaa
蚁	ykia
喇	lai
丞	cpai
拎	ly
吓	hxia
棠	tfio
咙	llia
梭	roei
哧	cii
棺	gwei
璇	xsee
瀚	hzoo
肝	gwu
敛	lsuo
剂	jmoe
疤	b/o
渔	yjoo
嗔	cyi
沮	jjo
廖	lvo
虏	ljie
皓	hvu
勋	xyi
恕	sna
虐	nxie
虞	yjie
综	zoa
瘾	yhoe
驴	ljaa
晒	scia
卦	g/ei
迦	j/au
陀	tlai
窥	keo
堕	dqa
哆	doia
葡	pjei
帖	tdi
垫	dzei
屡	ljae
鹅	ndue
蛛	vui
盲	mfo
碟	dde
狞	npu
囚	qli
诊	vho
揽	lsei
裴	pdie
捞	lt
吏	lmei
铮	v;ue
萄	tgei
盏	vsee
霆	tpeo
喔	woi
贷	dcui
勿	wnua
吭	k;i
淘	tgoo
辟	bmae
辟	pma
蔑	mxei
淹	ywoo
麒	qkoe
喽	loia
栗	lmei
绷	b;a
惚	huo
桓	hsei
坊	frei
桩	vrei
嗽	rqia
履	ljae
璐	lnee
菩	pjei
巢	cga
畜	cnoe
畜	xnoe
兀	wneu
樊	fse
锡	xiue
棚	ppei
仕	smui
倏	suui
芹	qhei
僻	pmu
絮	xnau
杏	x;ei
浆	jroe
浆	jco
啧	zdia
瘫	twoe
磁	ckeu
冈	gria
逮	dfa
逮	dca
搓	coei
赠	z;i
胶	jtua
脊	jkoe
噩	nxei
绰	cqa
呕	nli
嚼	jgi
嚼	jdi
谐	xdoa
舍	sxuo
歼	jwe
揣	crei
揣	cfei
殖	vkeu
拧	npe
伺	cmui
伺	rmui
霖	lheo
驼	tlaa
襄	xroe
衔	xsuu
惕	tmo
掷	vmei
卸	xxue
炽	cmo
敖	ngee
惭	csoo
框	kcei
捆	khe
眩	xzia
蝉	csia
谜	mkoa
炫	xzou
塘	tfei
阱	jpai
膜	mlu
亨	h;o
奕	ymoe
蚂	mai
蚂	m/ia
猩	x;ua
滨	byoo
沁	qb
跋	bai
藩	fwe
舔	tsue
捐	jwei
歧	qkie
隋	rda
蹭	c;i
甄	vye
蜡	l/ia
嗤	ciia
缸	grue
嬉	xia
哮	xtia
熄	xiou
窍	qvo
俞	yjuo
豁	haoo
豁	hoo
豁	hqoo
垒	lda
掘	jdei
琦	qkee
屎	skae
乍	v/u
孽	nxei
毯	tsue
弧	hja
槐	hfei
铠	kfu
挟	xdei
襟	jyoa
梨	lkue
嗅	xqi
祁	qkoa
纲	gra
渠	qjo
矢	skue
捅	tlei
扛	kfe
朽	xle
忖	cho
匈	xoua
扒	b/ei
扒	pae
雍	yooe
莺	y;ei
侮	wjui
闺	geoi
霓	nkeo
斋	vroe
稽	jiue
夭	ytue
沦	lhoo
揍	zqei
瞟	pgi
苟	glei
琉	llee
漪	yioo
暑	sjia
窟	kuo
钓	dvue
鳞	lhua
瓷	ckoe
萱	xwei
株	vuei
倭	wou
鞘	qvei
沛	pxo
噜	lu
绞	jga
颓	tdue
睿	rxie
噗	pui
唔	wjia
幢	vcia
喀	k/ia
诅	zjoa
涕	tmoo
拣	jsei
谣	ygo
叽	jii
葱	coei
拭	smei
婢	bmau
铸	vnue
绮	qkaa
剿	jgaa
胤	ybua
秩	vmue
畔	pzia
粥	voae
奎	kdeu
绸	claa
茨	ckei
觉	jvo
熏	xyue
蹬	d;ia
诏	vvo
岔	c/uo
叭	b/ia
咆	pgia
滥	lzoo
梧	wjei
垮	kae
澳	nvo
浙	vxo
甸	dzua
绯	feaa
诛	vuoa
鲍	bvua
刁	dta
厥	jdeu
蚊	whia
鞠	juei
歆	xyoe
拙	voei
茗	mpei
眷	jzou
戮	lnao
唬	hjia
骏	jbaa
扳	bwei
踹	ccia
漓	lkoo
蝇	ypi
擂	lxei
涡	woo
沌	dbo
凸	tui
蚩	cia
酿	ncei
唾	tqi
琐	rlee
犀	xiae
澄	d;oo
澄	cpoo
哉	zrei
猾	hau
煎	jwou
窒	vmoo
虾	x/ia
蝠	fjia
钞	ctu
瓣	bzoe
唧	jiia
觑	qni
哽	gpi
娥	nda
婿	xnau
讪	szoa
耕	g;
葫	hjei
暧	ncia
浇	jtoo
嗨	hri
诵	rqoa
疫	ymoe
兢	j;ei
箫	xtue
颅	ljie
啼	tkia
绅	syaa
杉	swei
嗜	smia
券	qzou
遁	dbuu
炯	jlo
霎	s/eo
讥	jioa
迭	ddue
彷	pfuu
觅	mmuo
娴	xsau
抿	mhe
剔	tii
稻	dvue
敷	fue
泻	xxoo
怠	dcao
龚	goeu
绒	rlaa
讳	hxoa
勺	sgu
函	hsa
喳	c/i
颂	rqu
搀	cwe
撩	lte
擎	qpe
巍	wei
脯	fjua
脯	pjua
镶	xrue
寥	lgoo
漾	yco
缴	jgaa
藉	jkei
藉	jxei
弊	bmou
逞	cpia
膏	gtoe
戳	coa
呛	qc
凹	nt
叩	kqi
禽	qhu
懊	nvoo
懈	xxoo
蛟	jti
亢	kco
呸	pei
芊	qwei
慑	sxoo
跺	dqi
跄	qci
蚀	skua
栖	qiei
蔚	wxei
铲	csue
坪	ppei
筝	v;ue
顷	qpea
腮	rru
别	bxia
踉	lci
划	hae
狰	v;ua
踱	dli
嗖	roia
苑	yzei
秉	bpue
猿	ysua
堤	die
佟	tlui
悯	mho
唠	lgi
唠	lvi
憨	hwa
肘	vlua
拇	mjei
僚	lgu
霹	pieo
婕	jdau
禹	yjui
啃	khi
匀	yhua
颤	vzoe
晖	heia
怅	cco
聋	lleu
拯	vpe
忿	fbu
韧	rbe
邹	zoua
梢	ste
肋	lxua
窘	jloo
嵌	qzi
婪	lsei
辖	xaea
浦	pjoo
炭	tzi
曦	xiia
簇	cnue
螺	llia
酱	jcoe
屯	th
悴	cxoo
匡	kre
冀	jmi
倔	jdui
橙	cpei
陕	ssa
筱	xgu
叱	cmia
髓	rdi
淳	choo
矜	jyao
詹	vwu
菱	lpei
芷	vkei
惺	x;oo
浊	vloo
囔	nri
朔	sqou
憔	qgoo
睫	jdia
睬	cfia
鸽	geuo
臀	tha
吨	dyi
笙	s;ue
戟	jkei
沼	vgo
谍	ddo
昕	xyia
蛊	gjia
煜	ynou
祀	rmo
罡	gria
伶	lpui
荫	yyei
荫	ybei
酥	rue
懦	nqoo
厄	nxeu
峨	ndi
轴	vlea
伽	j/ui
雳	lmeo
卵	lsua
捶	cde
檐	ysei
棘	jkei
嗣	rmia
钗	crue
袜	w/o
妩	wja
炕	kcou
偎	weui
窦	dqoo
蝎	xeia
溶	rloo
膨	ppua
峙	vmia
缉	jiaa
徊	hfuu
呗	beia
衅	xbu
砂	s/eu
舵	dqu
昼	vqae
迸	b;ou
斟	vyei
舆	yjui
椒	jte
靓	lcee
旬	xhua
厘	lkeu
窑	ygoo
萎	wdei
涟	lsoo
疙	geoe
瘩	d/o
瘩	dao
梵	fzei
靴	xeei
侥	jgui
匿	nme
挚	vmei
镯	vlue
兑	dxo
尧	ygea
徘	pfuu
芽	yaei
狙	juu
闵	mhoi
辫	bzoe
瀑	pno
嗷	ngi
庐	ljoe
芯	xyei
禾	hdue
澎	ppoo
邢	xpee
绊	bzaa
蜘	viia
憎	z;oo
靡	mkoe
褚	vjoa
湛	vzoo
蒲	pjei
嚓	c/ia
珂	keee
崽	zfi
贬	bsi
惮	dzoo
婵	csau
嗒	t/i
悸	jmoo
晦	hxia
涅	nxoo
恬	tsoo
慷	kroo
穹	qloo
渣	v/oo
屉	tma
缭	lgaa
绢	jzaa
袱	fjoa
黝	ylia
袅	ngua
淇	qkoo
茄	j/ei
茄	qde
寅	yhoo
赦	sxei
祟	rxa
榻	t/ei
蛙	w/i
苇	wdei
嵩	roia
茉	mqei
咏	ylia
凿	zgi
粪	fbou
噪	zvia
菌	jyei
蝙	bwi
庶	sno
邸	dkua
禧	xkoa
攒	zse
旱	hzia
虔	qsie
榴	llei
琛	cyee
漱	snoo
忑	txe
匣	xaea
忐	tsie
谬	mqoa
蟒	mfi
棱	lpei
钝	dbue
悚	rloo
廓	kqoe
惘	wfoo
漉	lnoo
蟹	xxua
佬	lgui
曳	yxia
赎	sjia
壤	rfe
忡	cooo
倡	ccui
冶	ydo
竿	gwue
蜷	qsia
癌	nfo
嘈	cgia
蚕	csee
剖	pooe
颁	bwuo
缀	cqaa
汀	t;o
谕	ynoa
牡	mju
斐	fdi
懵	mpoo
分	fbuo
斗	dlo
皙	xiei
缪	mva
缪	mla
蔷	qfei
诫	jxo
恤	xnoo
咄	doia
馒	msua
矫	jgue
痞	pkoe
橘	jjei
氧	yfue
贿	hxia
肮	nru
瑾	jhe
烙	lvou
璧	bmae
攘	rfei
攥	zzei
肖	xvio
汰	tcoo
溺	nmo
铅	qwue
咔	kai
芭	b/ei
戎	rlea
褐	hxoa
巩	glei
吆	yti
彰	vroe
漩	xsoo
聆	lpei
蒜	rzei
棕	zoe
鹃	jwia
帜	vmia
鄂	nxia
搐	cnei
蔼	nfei
怦	p;o
穗	rxue
亩	mjo
撰	vzei
绎	ymaa
牟	mlao
咨	zioe
奄	yweu
梓	zke
亲	q;oe
绚	xzaa
阀	fao
烘	hoou
炙	vmua
翎	lpuo
惋	wsoo
驯	xbaa
栩	xje
逾	yjuo
墟	xue
鬟	hsei
茬	caei
褪	tb
鑫	xyuo
骸	hfia
峭	qvi
缅	msaa
灶	zvou
洽	q/o
祯	vyo
暄	xwia
裔	ymoe
韶	sgo
缎	dzaa
砚	yzeu
锥	veu
辙	vdea
惦	dzoo
铛	c;u
枣	zge
桦	h/ei
邃	rxoo
橱	cjei
搔	rte
腑	fjua
解	xxua
萤	ypei
枢	suei
遏	nxia
募	mnei
憬	jpo
庵	nwo
叼	dtia
嫖	pga
苛	keei
锣	llue
蹑	nxia
拌	bzei
奠	dzou
秽	hxu
殴	noe
喋	ddia
糙	cto
貂	dtuo
揖	yiei
葵	kdei
榆	yjei
颐	ykei
皂	zvu
眈	dwi
扼	nxei
眺	tvi
孜	zia
簌	rnu
玺	xkua
偌	rqui
蹿	cwia
蓓	bxe
弛	ckae
庇	bmoe
檀	tsei
枭	xtua
螂	lfi
趾	vkia
崭	vsi
妲	daa
掂	dwei
醇	chei
掺	cwei
驿	ymaa
槽	cgei
惬	qxoo
镰	lsue
抡	lye
憧	cooo
删	swu
鸳	ywu
酣	hwe
宦	hzoo
筐	kru
琅	lfee
瞻	vwia
飙	bteu
湃	pco
俨	ysui
跷	qtia
栅	v/ei
栅	swei
撅	jeei
煽	swou
呱	guia
缰	jraa
猝	cnua
衮	gho
肴	yguo
殆	dceu
谴	qsoa
蔬	suei
飒	r/o
婧	j;a
阐	csoi
荧	ypei
侈	ckui
霏	feeo
瘟	wyo
芜	wjei
俭	jsu
崎	qkia
亥	hco
俐	lmui
屿	yjia
譬	pmae
饺	jgua
垄	lleu
畴	clia
杠	gcei
鬓	bbe
讼	rqoa
晏	yzia
弈	ymoe
鞍	nwe
瘸	qdo
钮	nlue
珏	jdee
钰	ynue
傀	kdui
噔	d;ia
驭	ynaa
靶	bae
萦	ypei
韬	ttee
恙	ycou
懿	ymei
竺	vjue
吝	lbo
羁	jiia
荀	xhe
癫	dwoe
嘭	p;i
菇	guei
恃	smoo
儡	ldu
瘪	beoe
瘪	bdo
踌	clia
呦	yoia
榕	rlei
昵	nmi
躇	cji
烬	jbou
啰	loia
酌	vlei
丙	bpei
涎	xsoo
哒	d/i
冽	lxoe
砌	qmeu
鸾	lsoe
烨	yxou
翟	vfa
翟	dka
辗	nsea
噎	yeia
驹	jua
噼	pii
咎	jqua
亵	xxoe
陨	yhai
蠕	rji
冕	msia
雌	ckie
茸	rlei
瑛	y;ee
剃	tmou
掰	bru
蹙	cneu
橡	xcei
佯	yfui
笃	djue
崛	jdia
勘	kwei
稼	j/ue
桀	jdua
渝	yjoo
汐	xioo
锈	xqu
磅	bceu
壕	hgei
娄	llou
撮	coei
撮	zlei
玑	jiee
祠	ckoa
娲	w/a
鹫	jqoe
黏	nsue
珀	pqe
睽	kdi
栓	swei
绫	lpaa
阑	lsoi
邑	ymia
瑕	xaee
磋	coeu
粟	rnei
薯	sje
沪	hnoo
讷	nxoa
岑	chia
炜	wdou
玮	wdee
娼	cra
迂	yu
伎	jmui
鲸	j;ua
翡	fdie
坝	b/ei
铐	kvu
洼	w/oo
蹊	xiia
寐	mxo
肾	sbii
鸯	yri
敝	bmou
涧	jzoo
崆	koi
甭	bpeu
笠	lmue
扈	hnoa
哝	nlia
芮	rxei
卉	hxei
靳	jbei
诬	wuoa
札	vae
婊	bga
裘	qlei
扉	feo
疮	croe
巅	dwia
坞	wnei
膳	szu
鳄	nxua
捺	n/e
悼	dvoo
茧	jsei
毋	wjaa
曙	sjia
馅	xzu
簸	blue
簸	bqu
忒	tee
奇	jieu
叟	rlui
拴	swei
嬷	m/a
稣	ruu
痹	bmoe
垣	ysei
蛤	gdi
蛤	haia
谏	jzoa
羹	g;o
沥	lmoo
蛾	ndia
瑚	hjee
熔	rlou
惆	cloo
雏	cjua
饷	xfu
拗	nve
拗	nqe
燎	lgou
熠	ymou
薰	xyei
蕃	fsei
捋	ljei
籁	lcu
髦	mgei
飓	jnua
簿	blue
簿	bnu
迢	tgau
闸	vao
狩	squa
鲨	s/oo
蜥	xiia
惴	vxoo
胯	k/u
侨	qgui
劭	svau
烹	p;oe
咣	gria
攸	youi
锄	cjue
硝	xteu
颔	hzu
鸥	noea
滕	tpua
寰	hsoo
紊	whoe
蕉	jtei
稠	clue
蟆	maia
垢	gqei
楷	kfei
炊	ceo
忻	xyoo
炳	bpou
腆	tsua
褒	bto
酋	qlou
赃	zri
拈	nwei
拈	nsei
抒	suei
孰	sjoe
袄	ngoa
褂	g/o
孺	rja
胭	ywua
赘	vxe
嫡	dkau
礁	jteu
啜	cqi
钳	qsue
晾	lcia
茎	j;ei
隧	rxai
窿	lloo
骋	cpaa
嫦	cfa
掳	ljei
槛	ksei
莞	gsei
莞	wsei
瓢	pge
曜	yvia
锯	jnue
猖	crua
遐	xaa
蹋	t/ia
飕	roua
渍	zmoo
麾	heoe
猥	wdua
篝	goue
殉	xbe
枷	j/ei
蜒	ysia
皎	jgui
霁	jmeo
诩	xjo
窖	jvoo
咫	vkae
檬	mpei
乒	p;u
奚	xiuo
淤	yuo
父	fjuo
溯	rnoo
凋	dto
纺	ffaa
篱	lkue
泌	mmoo
刨	bvua
刨	pgu
樵	qgei
忏	czoo
盎	ncia
戾	lmoa
阿	nea
咀	jji
屹	ymia
冲	cqoe
挎	k/e
羔	gtou
殃	yre
庚	g;oe
淼	mgia
淀	dzoo
隘	nca
绛	jca
缨	y;a
璨	cze
跤	jtia
锵	qrue
摁	nbe
痊	qsoe
嫔	pha
臻	vyea
泯	mhoo
糜	mdoe
睦	mni
喵	mti
缥	pta
褥	rnoa
魇	yseu
汶	wbo
馋	csua
渎	djoo
蜿	wwi
抠	koe
诶	neo
墩	dye
棣	dmei
沓	t/ia
喏	rdia
诲	hxoa
琶	paee
缈	mgaa
缔	dma
酝	ybei
耷	d/eu
弼	bmae
柬	jsei
浏	lloo
拷	kge
剁	dqua
柿	smei
琵	pkee
沂	ykoo
捻	nsei
帛	blui
柠	npei
饵	ndua
撂	lvei
娓	wdau
乓	pru
轲	keea
髯	rsei
娉	p;a
尽	jha
圭	geei
璀	cdee
苔	trei
苔	tfei
肪	ffua
吮	shi
瞩	vjia
啄	vlia
帷	wdia
箍	guue
蟑	vri
炖	dbou
梗	gpe
捎	stei
嗬	heia
蘑	mlei
唏	xiia
鹊	qxei
矶	jieu
羌	qro
骼	gdia
筛	srue
鲤	lkua
羲	xiou
祺	qkoa
馈	kxu
伫	vnui
羿	ymao
苞	btei
犁	lkue
啬	rxei
舷	xsuu
矗	cnei
癖	pkoe
掣	cxue
匾	bse
瀛	ypoo
谧	mmoa
珞	lqe
毓	ynue
衲	n/o
恺	kfoo
纬	wdaa
惰	dqoo
嘤	y;ia
诣	ymoa
谛	dmoa
藻	zgei
啷	lr
佘	sduo
黠	xaia
饲	rmua
虬	qlia
涤	dko
骡	llaa
钵	bou
邯	hsei
笋	rhue
芥	jxei
醺	xyei
佼	jgui
舜	sbuo
龌	wqi
簪	zwu
痰	tsoe
论	lhoa
蹂	rli
恻	cxoo
簧	hfue
甥	s;ue
腼	msua
单	csou
单	szou
驮	tlaa
缤	bya
潺	csoo
獠	lgua
筏	faue
锭	d;ue
阙	qeo
阙	qxoi
粤	yxui
瞌	keia
琏	lsee
龊	cqie
椎	vee
唆	roia
煦	xni
嵋	mdi
幡	fwia
翌	ymao
毡	vwue
碳	tzeu
鸨	bgua
闽	mhoi
躏	lbi
蜓	tpi
咻	xoia
捍	hzei
睨	nmia
鼾	hwu
桔	jjei
娆	rgau
抉	jdei
蜻	q;i
徨	hfuu
嗲	dai
碾	nseu
哐	kri
粼	lhou
啐	cxi
谑	xxoa
嚏	tmi
鳖	beou
榨	v/ei
倜	tmu
稷	jmue
篡	czu
晤	wni
肇	vvoa
咂	z/
帚	vla
瘤	lloe
瞠	c;ia
嚅	rjia
怆	ccoo
撵	nsei
裆	dro
腺	xzua
骁	xta
坷	kdei
螃	pfi
冢	vloa
锢	gnu
濒	byoo
蝗	hfia
烽	f;ou
莘	sye
辘	lnea
撬	qvei
瓮	w;u
亘	gbe
钊	vtu
篓	llue
缇	tka
宸	choo
胄	vqia
鞑	daei
羚	lpou
绥	rdaa
笺	jwu
荤	hye
迄	qmu
踞	jnia
桨	jfoe
慵	yooo
噤	jbia
幌	hfia
跚	swi
袒	tsoa
浣	hzoo
榄	lsei
痪	hzoe
荼	tjei
阉	ywoi
腋	yxua
骰	tlia
曝	pni
涮	szoo
踵	vlia
炬	jnou
涣	hzoo
俟	rmui
皑	nfui
瞑	mpia
渲	xzoo
擞	rlei
赂	lnia
湮	ywoo
麓	lnei
铿	k;u
埔	pjei
峦	lsoe
涓	jwoo
掬	juei
怏	ycoo
莓	mdei
萃	cxei
呲	zii
蹒	psi
鳌	ngee
睐	lcia
昱	ynia
旌	j;oe
摞	lqei
吠	fxi
濮	pjoo
谙	nwoa
啕	tgi
轶	ymea
搪	tfei
陇	llai
纨	wsaa
膺	y;oe
皋	gtu
霭	nfeo
呓	ymia
橄	gsei
纶	lha
垛	dqei
嗫	nxia
盅	voia
踝	hfia
臧	zreu
淅	xioo
岌	jki
岱	dcui
璞	pjee
缄	jwaa
秧	yru
翱	ngui
卤	ljie
逅	hquu
靥	yxeu
磐	psuu
壑	hxie
斓	lsoe
翊	ymoe
挛	lsoe
叁	rwao
佗	tlui
阖	hdoi
怂	rluo
戬	jsei
汲	jkoo
垠	yhei
迥	jli
咛	npi
邂	xxua
杞	qkei
痘	dqoe
臊	rvu
藕	nlei
媲	pmau
湄	mdoo
癞	lcoe
辄	vdea
獒	ngee
恪	kxoo
砾	lmeu
痉	j;oe
蜕	txi
椰	yeei
差	ciou
仨	r/u
纣	vqaa
馁	ndua
蜈	wjia
镐	ggue
窈	ygoo
秤	c;ue
粱	lfoo
辐	fjea
悖	bxo
涔	choo
偕	xdui
渭	wxoo
汴	bzoo
蜴	ymia
桅	wdei
隅	yjai
卯	mgua
骜	nvee
孚	fjuo
禺	yjia
琥	hjee
杵	cjei
掖	yeei
畸	jiia
晔	yxia
婀	neau
菡	hzei
噶	gaia
昙	tsia
坍	twei
俑	ylui
滤	lnoo
侏	vuui
潦	lgoo
挲	roo
硫	lleu
俸	f;ui
蟠	psia
弋	ymea
梆	brei
驸	fnaa
笈	jkue
忱	choo
恿	ylao
龟	jyua
胥	xua
垦	khae
窕	tgoo
滇	dwoo
珅	syee
圃	pji
咿	yii
徙	xkuu
瘴	vcoe
舫	ffuu
嗝	gdia
泞	n;o
藐	mgei
赣	gzoe
鹦	y;ia
逵	kdei
戍	sneu
榭	xxei
揩	krei
熹	xiei
蟾	csia
霾	mfeo
蔫	nwei
跛	bli
岐	qkia
脐	qkua
糗	qlou
螳	tfia
哺	bjia
鹭	lnia
蚣	goi
嵬	wdia
褶	vdo
恸	tqo
隽	jzui
玥	yxee
籽	zko
釜	fjuo
剐	gaia
鸠	jou
磷	lheu
娑	rooo
巳	rma
谄	csoa
恣	zmoe
猬	wxua
酪	lvei
丕	pieu
溟	mpoo
隼	rhui
芋	ynei
觊	jmia
筵	ysue
娣	dmau
盹	dh
涸	hdoo
劾	hdoe
颌	hduo
殇	sreu
轧	y/ea
沽	guo
愫	rnoo
鸢	ywea
玷	dzee
掸	dse
溥	pjoo
疵	cioe
皖	wsui
杳	ygei
镀	dnue
祎	yioa
鹉	wjee
匍	pjua
崴	wfia
岖	quia
幔	mzia
蝈	goia
镑	bcue
臆	ymua
偃	ysui
蜗	woia
瞰	kz
侬	nlui
郸	dwou
缆	lsa
袂	mxoa
诠	qsoa
犊	djue
摹	mlei
蟀	scia
邋	l/a
竣	jboe
骥	jmaa
泗	rmoo
痣	vmoe
贲	byei
胴	dqua
潼	tloo
弑	smuo
匐	fjua
姣	jtau
谤	bco
蘸	vzei
蟋	xiia
渥	wqoo
浒	hjoo
蛐	quia
阂	hdoi
糯	nqou
愠	yboo
嵇	jiue
谒	yxoa
舀	yguo
否	pkeu
呤	lpia
槟	byei
嘣	b;ia
脓	nlua
樟	vrei
忪	vooo
蛰	vdei
咤	v/ia
阜	fnui
峥	v;ia
濡	rjoo
遢	t/ia
担	dsei
瑙	ngee
碉	dte
孵	fuua
讹	ndoa
彝	ykaa
颀	qkuu
篆	vzue
臾	yjui
椭	tlei
沏	qioo
颦	phie
蛆	quia
淆	xgo
揄	yjei
压	y/eu
嗑	kxi
踮	dsia
犷	gfu
荔	lmei
鳅	qoua
闫	ysoi
隗	wdai
渤	bloo
馍	mlua
锏	jsue
楣	mdei
蜃	sbe
遛	lqu
查	v/ei
倌	gwui
氤	yyue
戌	xueu
嶙	lhia
馗	kdua
匮	kxea
揶	ydei
胚	peu
啻	cmoe
敕	cmei
夙	rnua
珈	j/ee
锹	qtu
摒	b;e
迩	ndua
啾	joi
峪	ynia
菠	boei
馥	fnue
槌	cdei
褛	ljoa
贻	ykia
礴	bleu
豚	thu
氲	yyue
湍	twoo
腌	ywua
蚱	v/ia
殡	bbeu
毗	pkia
耙	paee
诽	fdo
褴	lsoa
瘁	cxoe
蚌	bci
铝	ljue
蔻	kqei
憩	qmue
锚	mgue
濑	lcoo
耘	yhee
俾	bkui
鬃	zoei
裟	s/oo
苒	rsei
蘅	hpe
鱿	ylua
傥	tfui
袈	j/au
豺	cfuo
町	tpia
掇	doei
坯	piei
戛	jaeu
贮	vnia
塾	sjoe
剽	ptei
孬	nte
衩	caoa
镣	lvu
戊	wneu
犟	jcae
酉	ylei
斡	wqei
匝	z/e
诘	jdoa
攫	jdei
潢	hfoo
黔	qsia
臃	youa
罂	y;ia
轼	smea
酗	xnei
嘹	lgia
阪	bsa
冗	rloa
桧	gxei
皿	mhi
囡	nwi
辍	cqea
觎	yjuo
浚	jboo
闰	rboi
臼	jqui
蹩	bdou
煲	btui
怵	cnoo
囤	thi
罔	wfia
蚓	yhia
碴	caeu
灸	jlua
蚯	qoi
嗥	hgia
堑	qzea
箴	vyue
谗	csoa
嵘	rlia
箩	llue
碱	jseu
葆	bgei
旎	nkoe
谆	vyoa
粽	zqou
牒	ddui
泸	ljoo
刽	gxuo
诋	dkoa
缜	vha
爻	yguo
贰	nxea
坳	nvei
睑	jsi
葭	j/ei
妪	ynau
镂	lque
癸	gdao
笆	b/ue
壬	rhue
绉	vqaa
抨	p;ei
叵	ple
箕	jiue
坨	tlei
颉	jdei
姹	c/au
赳	joei
焊	hzou
淬	cxoo
纭	yhaa
埠	bnei
泱	yro
恹	ywoo
榛	vyei
酵	jvei
銮	lsoe
佶	jkui
犒	kvue
茱	vuei
饪	rbu
孪	lsoe
砺	lmeu
遽	jnie
嗟	jei
钙	gcue
谚	yzoa
鲲	kyu
谟	mloa
馊	roua
雉	vmue
虱	siau
糠	krou
赈	vbi
旮	g/ua
骠	bta
峋	xhi
跆	tfia
瘠	jkoe
饕	tti
佚	ymui
淄	zioo
谀	yjoa
镳	btue
读	dqoa
廿	nzei
喟	kxia
偻	llui
绺	llaa
骨	guia
沱	tloo
囱	coui
兖	ysoe
袤	mvoe
畿	jiaa
诌	vooa
苯	bhe
佻	ttu
魈	xtui
屌	dgae
谲	jdoa
泾	j;oo
獗	jdua
蹶	jdia
绔	kna
雹	bgeo
旯	laia
洱	ndoo
馄	hhua
粲	czie
哂	shia
蔗	vxei
饨	thua
奘	zca
芍	sge
淞	rooo
腴	yjua
剜	wwoo
汾	fho
顼	xuee
濂	lsoo
蜚	fdie
殒	yheu
鹞	yvuo
蚤	zga
浃	j/o
坂	bsei
颚	nxia
忤	wjo
眦	zmi
彗	hxee
暹	xwia
赧	nsei
佝	goui
钺	yxue
嘞	lei
硅	geeu
玳	dcee
蛹	ylia
睾	gtui
盂	yjee
赁	lbu
瑁	mvee
骛	wna
宕	dco
纂	zsu
堰	yzei
厩	jqe
萋	qiei
帔	pxi
杈	c/ei
熨	ybae
挞	t/ei
觐	jbei
煊	xwou
钏	czue
泫	xzoo
迳	j;ao
缮	sza
燧	rxou
孱	csae
懑	mbo
柩	jqei
漕	cgoo
鹄	hjue
龛	kwu
饯	jzua
餮	txeu
幄	wqia
鹘	gjia
倨	jnui
诙	heoa
锃	z;u
颧	qsei
纰	piaa
鏖	ngoe
氢	q;ue
楔	xeei
藜	lkei
栀	viei
谥	smoa
骧	xraa
犄	jiue
葳	weei
魑	ciu
聒	goei
椿	cyei
伢	yaui
谩	msoa
鹜	wnao
燕	ywei
闩	swoi
颍	ypua
濠	hgoo
仞	rbui
鳗	msua
踊	ylia
痿	wdoe
皈	geui
骊	lka
孑	jdai
帼	glia
撸	lue
檄	xkei
啵	boia
柚	yqe
篑	kxue
陲	cda
潋	lzoo
樽	zye
遨	ngee
舶	bluu
莆	pjei
蛀	vnia
抻	cyei
搽	caei
俪	lmui
铉	xzue
嚯	hqi
茁	vlei
韭	jlie
膘	btua
酩	mpei
榔	lfei
娩	msau
汗	hzoo
刎	whua
扪	mhei
漳	vroo
仃	d;ui
饬	cmua
壹	yiei
裨	bmoa
裨	pkoa
巽	xbae
黜	cni
滂	pro
鹂	lkei
徉	yfuu
戕	qra
埂	gpei
纫	rbaa
溉	gcoo
胛	jau
锌	xyue
遑	hfui
跻	jiia
蒿	ht
钛	tcu
岷	mhia
葩	p/e
磺	hfeu
汕	szoo
肛	grua
涿	vooo
鲛	jtua
睥	bmi
滦	lsoo
稔	rhue
锲	qxu
徜	cfuu
冼	xsoe
獐	vru
喙	hxia
讧	hqoa
氨	nwu
褓	bgoa
赊	sei
菀	wsei
鄱	plu
炅	gxia
碜	cheu
戗	qruo
瓴	lpuo
酊	dpei
钠	n/u
镌	jwue
铀	ylue
羯	jdou
挝	woe
襁	qfo
渚	vjoo
胫	j;ua
雎	jui
砥	dkeu
衢	qju
狒	fxua
骞	qwoo
荟	hxei
华	haui
号	hvia
正	v;ei
石	dzeu
汛	xboo
色	sfua
盥	gzui
睚	yaia
栎	lmei
砣	tleu
烩	hxou
夯	hreu
拮	jdei
驷	rmaa
殓	lze
哔	bmia
徇	xbuu
蹴	cnia
忾	kcoo
疹	vhoe
鸵	tlua
韫	ybee
祛	quo
膻	swua
黢	quia
仄	zxeu
唳	lmi
烊	yfou
烊	ycou
孀	sra
腚	d;ua
牍	djui
佃	dzui
赡	szi
秣	mque
榷	qxei
镭	ldue
铄	sque
嫒	ncau
饽	boua
谌	choa
啮	nxia
蝼	llia
闱	wdoi
篙	gtue
逡	qya
膑	bbua
隍	hfai
罄	q;ei
蕨	jdei
囵	lhia
橹	ljei
睢	rei
喱	lki
肓	hro
榈	ljei
绶	sqa
槊	sqou
罹	lkia
槁	gge
秸	jeue
裱	bgoa
牦	mgue
滓	zkoo
腓	fdua
砝	fae
舐	smue
谶	cboa
秆	gsue
荏	rhei
斛	hjua
暨	jmae
滟	yzoo
纾	suaa
粑	b/ou
诳	kfoa
寮	lgoo
鹑	choe
驽	njau
囫	hjia
徕	lfuu
弭	mkae
橇	qte
痢	lmoe
圜	hsia
撺	cwei
柑	gwei
儆	jpu
魉	lfui
妊	rbau
氏	viua
酶	mdei
庖	pgoe
缢	ymaa
俎	zju
鲫	jmua
藓	xsei
佰	bfui
痔	vmoe
觥	goua
哞	moi
伉	kcui
怄	nqoo
轱	guea
泵	b;eu
擀	gsei
蝌	keia
绌	cna
蓑	roei
釉	yquo
翳	ymea
讫	qmoa
蜇	veei
蜇	vdei
砧	vyeu
殄	tseu
萼	nxei
胰	ykua
蜍	cjia
瘀	yuoe
鸪	guei
霰	xzeo
鹧	vxoe
诨	hboa
僭	jzui
弁	bzao
湎	msoo
栉	jdei
蹉	coi
醍	tkei
磬	q;ei
泷	lloo
蓼	lgei
铂	blue
梏	gnei
鸩	vbo
豌	wwe
嘬	zoia
疡	yfoe
荞	qgei
涝	lvoo
蛔	hdi
焖	mbou
祉	vko
魍	wfui
跎	tlia
锉	cque
桎	vmei
喆	vdei
娠	syau
诿	wdoa
瓯	noea
殚	dweu
镁	mdu
痂	j/oe
胱	grua
刍	cjua
醐	hjei
糅	rlou
愎	bmoo
赝	yzeu
唁	yzia
笳	j/ue
崂	lgia
踽	jjia
鳍	qkua
帧	vyia
骈	psa
仟	qwui
羸	ldo
谪	vdoa
狲	ryu
槃	psuu
珲	heee
蛭	vmia
痍	ykoe
猢	hjua
鼹	ysui
悌	tmoo
莅	lmei
咩	mei
誊	tpou
鳝	szua
韪	wdia
噱	jdia
俚	lkui
硌	gxeu
脍	kcua
汞	glei
淖	nvoo
姘	pya
聩	kxei
泅	qloo
喑	yyia
绦	dkaa
铡	vaue
恽	yboo
遒	qlou
痨	lgoe
蚪	dlia
蒺	jkei
觞	srua
葺	qmei
煅	dzou
悱	fdoo
茕	qlei
靛	dzee
诓	kroa
箔	blue
珥	ndee
岬	jaia
臬	nxui
肱	goua
焙	bxou
鸷	vmei
蜢	mpia
莠	ylei
铨	qsue
胺	nzua
堇	jhei
嶂	vcia
钾	jaue
跹	xwia
鹌	nweu
笞	ciue
缛	rnaa
椽	csei
苕	tgei
酮	tlei
婺	wnao
貉	hduo
囿	yqi
铣	xkue
舂	coee
碘	dseu
馔	vzua
铢	vuue
涪	fjoo
氯	lnue
傣	dfu
度	dloe
篾	mxue
猕	mku
砒	pieu
颛	vwia
柒	qioo
饴	ykua
圩	wdei
疱	pvoe
圄	yjia
橐	tlei
枸	glei
貅	xouo
蛎	lmia
唢	rlia
窠	keoo
囹	lpia
撷	xdei
伥	crui
疟	nxoe
傩	nlui
诟	gqo
嗞	ziia
赅	gria
楂	v/ei
氮	dzue
竽	yjue
碣	jdeu
谔	nxoa
铧	haue
铆	mgue
滁	cjo
遴	lhou
舛	csua
荠	jmei
稞	keu
阄	joo
荚	jaei
媪	nga
悒	ymoo
笏	hnu
晷	gdia
宥	yqoo
豸	vmuo
摈	bbei
凫	fjua
阡	qwa
粕	pqo
癣	xsoe
珐	f/e
馏	llua
龈	yhie
锒	lfue
虻	mpia
腩	nsua
吖	n/ia
瓤	rfo
楫	jkei
镊	nxue
阆	lcoi
豕	skeu
擘	bqa
玎	d;ee
馐	xoua
潍	wdoo
龅	btie
黩	djia
芪	qkei
砭	bweu
腱	jzua
挈	qxee
怼	dxa
嬗	szau
貔	pkuo
杷	paei
讴	noo
铬	gxue
沆	hcoo
蝮	fnia
烷	wsou
箜	kou
揿	qbe
茴	hdei
鲈	ljua
昴	mgia
缟	gga
瘙	rvo
痫	xsoe
矾	fseu
氖	nfue
烯	xiou
铰	jgue
妯	vlau
耄	mvei
搦	nqei
飨	xfaa
鳏	gwua
痼	gnoe
讣	fnoa
馕	nfua
鲇	nsua
妁	sqau
垩	nxei
枇	pkei
幂	mmoa
蟊	mgao
萁	qkei
鹳	gze
盱	xuia
帑	tfa
侪	cfui
娌	lkau
煸	bwo
孳	ziou
蚋	rxia
脔	lsoe
箬	rque
樯	qfei
趸	dhe
苣	jnei
萸	yjei
謇	jsoo
妣	bka
啁	voia
氰	qpu
蒹	jwei
莴	woei
夤	yhua
鹬	ynao
腭	nxua
鲑	geua
淦	gzoo
鲠	gpu
蚝	hgia
瀣	xxoo
骐	qkaa
堀	kuei
柞	zqei
泔	gwoo
锰	mpue
蟥	hfia
薅	hte
嵯	clia
蛳	riia
篦	bmue
荜	bmei
焯	ctou
芡	qzei
螯	ngee
眙	ykia
肄	ymua
荨	qsei
耋	ddei
俳	pfui
铱	yiue
薮	rlei
笄	jiue
渑	msoo
豉	ckei
疣	yloe
镍	nxue
轳	ljea
熵	srou
瘆	sboe
杼	vnei
诂	gjo
鲶	nsua
氟	fjue
洄	hdoo
孢	btai
郴	cyei
詈	lmia
鞣	rlei
蜉	fjia
耦	nlee
蛉	lpia
箪	dwue
愆	qwuu
藿	hqei
痱	fxoe
纡	yua
葚	sbei
黧	lkue
毖	bmea
髋	kwi
坻	dkei
蜊	lkia
铙	ngue
漯	t/o
骟	szaa
捌	b/ei
椴	dzei
墒	srei
溘	kxoo
牖	ylui
蹚	tri
阋	xmo
龋	qjie
刈	ymuo
悭	qwoo
蠲	jwou
瓠	hneu
圪	geei
轾	vmea
麸	fuee
锱	ziu
瞽	gjei
糍	ckou
蹼	pjia
鳕	xdua
偬	zlui
榫	rhei
秭	zku
瘢	bwoe
殍	pgeu
碇	d;eu
碓	dxe
孓	jdai
痧	s/oe
痈	yooe
埚	goei
壅	yooe
怙	hnoo
癔	ymoe
潆	ypoo
檩	lhei
痤	cloe
嘚	deia
菽	suei
茭	jtei
酰	xwei
菏	hdei
诹	zoo
粳	j;ou
糌	zwo
舸	gduu
趵	bvia
枥	lmei
膈	gdua
傧	byu
鸬	ljie
艿	nfei
酚	fyei
椟	djei
氦	hcu
笸	plue
疸	dso
醛	qsei
篌	hlue
枳	vkei
酯	vkei
髫	tgei
缳	hsaa
孥	njau
溧	lmoo
镬	hque
卺	jhai
皴	cyao
鍪	mlao
坩	gwei
砻	lleu
郯	tsou
筚	bmue
跬	kdia
醚	mke
蚧	jxi
肽	tcua
绀	gzaa
顸	hwee
谵	vwoa
鲟	xhua
屣	xkae
鹚	ckou
焗	jjou
疖	jeo
炝	qco
啉	lhia
硒	xieu
伛	yjui
蛄	guia
燹	xseu
缫	rta
髀	bmia
凇	rooe
鼙	pkei
悛	qwoo
轫	rbea
苷	gwei
萏	dzei
羝	diou
蘖	nxei
蚍	pkia
桡	rgei
耨	nqee
搴	qwoo
榧	fdei
蚜	yaia
轭	nxea
皲	jyoa
胝	viua
蝣	ylia
鲋	fnua
硼	ppeu
葸	xkei
溏	tfoo
鲱	feu
溽	rnoo
滏	fjoo
彖	tza
耜	rmee
嫠	lkee
锂	lkue
劬	qjua
颟	mw
曈	tlia
濞	bmoo
郫	pkui
怍	zqoo
螨	msia
阈	ynoi
肫	vyua
蝰	kdia
蝓	yjia
暌	kdia
蒌	llei
颞	nxei
鲷	dtua
囟	xbui
溴	xqoo
畚	bha
癜	dzoe
辊	ghe
嘌	pti
烃	t;ou
柽	c;ei
秕	bkue
豇	jre
蛞	kqia
颃	hfoe
骶	dkia
鳔	bvua
髂	q/i
瘘	lqoe
胗	vyua
髌	bbi
楦	xzei
籼	xwou
齁	hou
骒	kxa
堙	yyei
袪	quoa
酞	tcei
鲻	ziua
氪	kxue
