的	的话	的确
了	了解	了不起
一	一个	一下
是	是不是	是因为
不	不是	不过
我	我们	我会
这	这个	这么
在	在家	在意
有	有些	有点
你	你们	你好
个	个人	个子
人	人家	人生
来	来到	来说
他	他们	他家
着	着急	着实
就	就是	就算
说	说道	说完
说	说道	说完
到	到底	到时候
么	么妹儿	
上	上面	上课
道	道歉	道理
看	看着	看到
也	也许	也好
那	那个	那么
子	子弹	子女
大	大家	大学
没	没有	没事
好	好像	好好
下	下来	下去
时	时候	时间
还	还是	还有
去	去世	去年
出	出来	出现
自	自己	自然
小	小子	小时
过	过来	过去
要	要是	要求
然	然后	然而
里	里面	里边
天	天空	天天
后	后面	后来
都	都市	都还没
想	想到	想要
会	会议室	会议
会	会议室	会议
可	可以	可是
能	能够	能力
起	起来	起身
己	己方	己任
心	心里	心中
以	以后	以为
为	为什么	为了
对	对于	对方
中	中国	中间
得	得到	得意
地	地方	地上
手	手机	手中
什	什么	什么样
开	开始	开口
她	她们	她家
头	头发	头上
家	家里	家伙
生	生活	生命
身	身体	身上
只	只是	只有
样	样子	样貌
老	老师	老板
面	面前	面对
和	和尚	和谐
点	点头	点点头
多	多少	多年
啊	啊啊啊	啊呀
事	事情	事儿
现	现在	现实
知	知道	知识
很	很多	很快
话	话题	话语
而	而且	而是
眼	眼睛	眼前
走	走进	走出
之	之后	之前
回	回来	回到
些	些许	些小
前	前面	前世
学	学校	学生
发	发现	发生
打	打开	打算
吧	吧台	吧唧
给	给予	给出
给	给予	给出
经	经过	经常
笑	笑容	笑了笑
女	女孩	女人
把	把手	把头
间	间隔	间接
声	声音	声响
但	但是	但愿
情	情况	情绪
意	意思	意识
无	无奈	无法
被	被子	被窝
让	让开	让给
两	两个	两年
气	气息	气氛
真	真的	真是
年	年轻	年轻人
已	已经	已然
见	见到	见面
见	见到	见面
所	所以	所有
如	如果	如此
又	又称	又名
怎	怎么	怎么样
几	几个	几天
于	于是	于是乎
方	方向	方式
成	成为	成绩
问	问道	问题
力	力量	力气
当	当然	当时
觉	觉得	觉醒
明	明白	明天
张	张扬	张开
边	边上	边缘
李	李家	李子
林	林子	林家
用	用力	用来
感	感觉	感到
才	才能	才刚
从	从小	从来
听	听到	听见
长	长大	长发
长	长大	长发
口	口气	口袋
动	动作	动手
候	候车室	候选人
正	正在	正是
王	王子	王明
定	定格	定位
再	再次	再说
脸	脸上	脸色
白	白色	白天
次	次数	次日
进	进入	进来
直	直接	直到
高	高兴	高中
三	三个	三年
最	最后	最好
门	门口	门外
刚	刚才	刚刚
同	同学	同时
实	实在	实力
别	别人	别的
本	本来	本书
神	神秘	神色
儿	儿子	儿女
完	完全	完成
做	做出	做到
接	接着	接受
少	少年	少女
行	行李	行动
行	行李	行动
向	向着	向前
分	分钟	分别
吗	吗啡	吗啉
种	种种	种子
种	种种	种子
因	因为	因此
车	车子	车上
车	车子	车上
十	十分	十年
像	像是	像样
快	快速	快点
其	其实	其他
其	其实	其他
跟	跟着	跟前
等	等等	等待
吃	吃饭	吃惊
住	住院	住处
此	此时	此刻
却	却是	却说
果	果然	果断
男	男人	男子
呢	呢喃	呢子大衣
光	光芒	光头
色	色彩	色狼
色	色彩	色狼
外	外面	外号
放	放在	放心
哥	哥哥	哥们
叫	叫做	叫声
作	作为	作者
死	死亡	死去
便	便是	便宜
便	便是	便宜
机	机会	机械
将	将来	将近
二	二人	二楼
法	法术	法律
找	找到	找死
名	名字	名叫
东	东西	东方
体	体内	体质
全	全部	全身
太	太阳	太好了
应	应该	应聘
电	电话	电脑
带	带来	带上
风	风景	风格
师	师傅	师父
位	位置	位于
陈	陈家	陈老师
比	比较	比如
算	算是	算了
安	安静	安排
字	字数	字迹
孩	孩子	孩童
主	主人	主要
理	理解	理由
叶	叶子	叶家
叶	叶子	叶家
公	公司	公交车
先	先生	先是
飞	飞机	飞快
水	水平	水晶
今	今天	今年
拿	拿出	拿到
相	相信	相当
轻	轻轻	轻松
更	更加	更是
钱	钱包	钱财
黑	黑色	黑暗
美	美女	美丽
西	西装	西服
第	第一次	第一
重	重要	重新
重	重要	重新
思	思考	思想
并	并且	并非
龙	龙哥	龙阳
难	难道	难以
清	清楚	清晰
者	者阴山	者奈
离	离开	离去
变	变得	变成
世	世界	世间
刘	刘海	刘老师
路	路上	路边
关	关系	关于
始	始终	始祖
空	空间	空气
何	何时	何况
周	周围	周末
坐	坐在	坐下
妈	妈妈	妈呀
常	常常	常人
文	文化	文字
音	音乐	音响
哈	哈哈	哈哈哈
转	转身	转过
该	该死	该是
强	强大	强烈
强	强大	强烈
场	场景	场面
信	信息	信心
亲	亲自	亲人
早	早就	早上
处	处理	处于
数	数字	数学
任	任务	任何
校	校长	校园
校	校长	校园
马	马上	马路
入	入学	入侵
望	望去	望了望
许	许多	许久
国	国家	国内
表	表情	表现
姐	姐姐	姐妹
虽	虽然	虽说
满	满脸	满意
随	随着	随后
干	干嘛	干什么
竟	竟然	竟是
加	加上	加入
原	原来	原因
微	微微	微笑
突	突然	突破
月	月光	月亮
紧	紧张	紧紧
内	内心	内容
连	连忙	连续
万	万一	万物
万	万一	万物
哪	哪里	哪个
活	活动	活着
站	站住	站立
平	平时	平静
房	房间	房子
四	四个	四周
谁	谁知	谁家
云	云天	云海
爷	爷爷	爷爷奶奶
红	红色	红包
红	红色	红包
花	花钱	花痴
阳	阳光	阳台
新	新生	新书
书	书包	书友
静	静静的	静静地
目	目光	目标
解	解释	解决
解	解释	解决
远	远处	远远
通	通过	通知
服	服务员	服务
记	记得	记忆
受	受到	受伤
慢	慢慢	慢悠悠
反	反应	反正
杨	杨树	杨柳
班	班主任	班级
似	似乎	似的
似	似乎	似的
山	山上	山洞
部	部队	部分
跑	跑车	跑过来
认	认识	认为
倒	倒霉	倒下
越	越来越	越发
且	且不说	且说
且	且不说	且说
海	海洋	海边
晚	晚上	晚饭
惊	惊讶	惊喜
工	工作	工资
物	物品	物质
帮	帮助	帮忙
喜	喜欢	喜悦
金	金色	金属
怕	怕死	怕怕
影	影响	影子
与	与此同时	与其
冷	冷笑	冷静
爱	爱情	爱好
友	友谊	友好
脑	脑袋	脑海
往	往往	往常
办	办法	办公室
步	步伐	步子
总	总是	总算
灵	灵魂	灵气
嘴	嘴里	嘴角
错	错误	错过
五	五个	五年
教	教室	教官
界	界面	界限
饭	饭店	饭菜
刻	刻苦	刻意
至	至于	至少
乎	乎呼	
弟	弟弟	弟子
语	语气	语文
每	每天	每个
玩	玩笑	玩意
量	量子	量身
指	指着	指向
青	青年	青春
雨	雨水	雨伞
火	火车	火焰
室	室友	室内
双	双手	双眼
半	半个	半天
结	结果	结束
传	传来	传说
传	传来	传说
欢	欢迎	欢快
系	系统	系列
系	系统	系列
容	容易	容貌
句	句子	句号
句	句子	句号
忙	忙碌	忙活
失	失去	失望
收	收拾	收藏
父	父亲	父母
血	血液	血脉
衣	衣服	衣领
谢	谢谢	谢谢你们
拉	拉开	拉拉
度	度过	度假
落	落下	落地
管	管理	管家
日	日子	日本
爸	爸爸	爸妈
整	整个	整理
准	准备	准确
酒	酒吧	酒店
奇	奇怪	奇迹
奇	奇怪	奇迹
雪	雪儿	雪白
般	般的	般地
凡	凡人	凡是
流	流氓	流出
非	非常	非凡
星	星期	星球
件	件物品	件数
赵	赵云	赵家
宇	宇宙	宇文
立	立刻	立马
梦	梦想	梦境
杀	杀手	杀人
旁	旁边	旁人
特	特别	特殊
楚	楚楚	楚歌
由	由于	由此
命	命运	命令
苏	苏醒	苏子
视	视线	视频
怪	怪物	怪异
合	合适	合同
合	合适	合同
底	底下	底气
市	市场	市里
包	包括	包裹
提	提醒	提升
提	提醒	提升
息	息怒	息息相关
终	终于	终究
备	备注	备用
条	条件	条件反射
识	识相	识趣
识	识相	识趣
保	保安	保护
告	告诉	告别
司	司机	司徒
乐	乐意	乐趣
乐	乐意	乐趣
单	单位	单纯
单	单位	单纯
单	单位	单纯
近	近乎	近距离
答	答应	答案
题	题目	题材
夏	夏天	夏日
脚	脚步	脚下
睡	睡觉	睡着
伤	伤害	伤口
冲	冲着	冲动
够	够呛	够不够
夜	夜晚	夜色
请	请问	请假
言	言语	言辞
楼	楼下	楼上
性	性格	性感
呵	呵呵	呵斥
呵	呵呵	呵斥
停	停下	停止
根	根本	根据
修	修炼	修改
城	城市	城里
丝	丝毫	丝丝
深	深深	深处
睛	睛明穴	睛天
母	母亲	母子
片	片刻	片子
显	显得	显然
百	百年	百里
华	华夏	华丽
敢	敢不敢	敢动
战	战斗	战争
级	级别	级任务
秦	秦天	秦川
交	交给	交流
切	切磋	切记
黄	黄毛	黄金
急	急忙	急促
穿	穿着	穿越
久	久久	久违
绝	绝对	绝望
装	装作	装备
业	业务	业绩
考	考虑	考试
兴	兴奋	兴趣
续	续命	续写
顿	顿时	顿饭
警	警察	警官
消	消失	消息
阵	阵阵	阵法
赶	赶紧	赶忙
妹	妹妹	妹子
喝	喝酒	喝完
响	响起	响声
它	它们	它山之石
异	异能	异常
员	员工	员外
速	速度	速度快
留	留下	留在
害	害怕	害羞
院	院子	院长
苦	苦笑	苦涩
使	使用	使得
朋	朋友	朋友圈
击	击中	击杀
石	石头	石子
石	石头	石子
化	化作	化为
凌	凌晨	凌云
摇	摇头	摇摇头
武	武器	武功
亮	亮光	亮起
暗	暗暗	暗自
背	背后	背影
毕	毕竟	毕业
确	确实	确定
千	千万	千年
断	断断续续	断裂
照	照顾	照片
或	或者	或许
易	易水寒	易经
各	各种	各位
买	买点	买来
代	代表	代价
差	差不多	差点
差	差不多	差点
围	围着	围观
即	即使	即将
唐	唐天	唐朝
台	台上	台下
医	医院	医生
队	队长	队伍
拍	拍了拍	拍拍
呼	呼吸	呼呼
依	依旧	依然
醒	醒来	醒过来
板	板凳	板砖
精	精神	精致
习	习惯	习惯性
淡	淡淡的	淡淡
破	破旧	破坏
军	军训	军人
浩	浩然	浩瀚
送	送到	送给
角	角落	角色
待	待遇	待会儿
吴	吴子	吴起
钟	钟离	钟声
计	计划	计较
务	务必	务农
期	期待	期间
期	期待	期间
报	报告	报道
晓	晓得	晓之以理
默	默默	默默地
写	写作	写下
掉	掉落	掉下来
阿	阿姨	阿飞
鬼	鬼魂	鬼脸
况	况且	况味
求	求求	求饶
萧	萧然	萧瑟
决	决定	决心
功	功夫	功法
八	八卦	八点
块	块钱	块头
伙	伙伴	伙计
继	继续	继承
试	试试	试卷
混	混混	混蛋
利	利用	利益
低	低头	低着头
沉	沉默	沉重
露	露出	露露
简	简单	简直
球	球场	球员
峰	峰顶	峰回路转
必	必须	必要
叔	叔叔	叔伯
哦	哦哦哦	
诉	诉说	诉说着
复	复杂	复习
江	江湖	江南
课	课本	课程
注	注意	注视
顾	顾客	顾不得
店	店里	店铺
抱	抱歉	抱怨
朝	朝着	朝阳
朝	朝着	朝阳
呀	呀呀	呀呀学语
刀	刀疤	刀子
段	段时间	段子
若	若有所思	若隐若现
床	床上	床边
肯	肯定	肯德基
客	客气	客厅
尽	尽管	尽量
疑	疑惑	疑问
群	群众	群体
桌	桌子	桌上
号	号码	号称
众	众人	众多
木	木头	木棍
缓	缓缓	缓缓的
制	制作	制造
兄	兄弟	兄妹
需	需要	需求
居	居然	居住
初	初中	初三
程	程度	程序
古	古代	古怪
格	格外	格斗
极	极为	极其
您	您好	您老
靠	靠近	靠着
玉	玉佩	玉石
晨	晨曦	晨练
米	米饭	米左右
热	热闹	热情
痛	痛苦	痛快
未	未来	未知
足	足够	足以
招	招呼	招手
莫	莫名	莫名其妙
除	除了	除非
及	及时	及其
持	持续	持枪
游	游戏	游客
超	超级	超过
充	充满	充数
希	希望	希冀
份	份子	份儿
则	则安之	则甚
喊	喊道	喊声
冰	冰冷	冰箱
势	势力	势头
推	推开	推荐
孙	孙子	孙悟空
形	形成	形象
胖	胖子	胖胖的
狠	狠狠	狠心
拳	拳头	拳法
跳	跳动	跳跃
抓	抓住	抓起
南	南宫	南方
左	左右	左手
细	细节	细细
病	病房	病人
乱	乱七八糟	乱说
股	股票	股份
陆	陆续	陆陆续续
魔	魔法	魔鬼
轩	轩辕	轩辕剑
首	首先	首歌
右	右手	右边
类	类似	类型
选	选择	选项
宝	宝贝	宝宝
另	另外	另一边
排	排名	排队
忍	忍不住	忍住
韩	韩国	韩语
味	味道	味儿
午	午饭	午餐
品	品牌	品尝
徐	徐徐	徐福
士	士兵	士气
七	七点	七个
丽	丽丽	丽莎
皮	皮肤	皮鞋
罗	罗兰	罗盘
线	线索	线条
练	练习	练武
渐	渐渐	渐暗
区	区别	区域
区	区别	区域
烟	烟雾	烟头
吸	吸引	吸收
瞬	瞬间	瞬移
六	六个	六点
护	护士	护栏
怒	怒火	怒吼
术	术士	术语
术	术士	术语
辰	辰星	辰龙
毛	毛病	毛巾
巴	巴掌	巴不得
凑	凑足	凑合
熟	熟悉	熟练
建	建筑	建议
达	达到	达成
剑	剑眉	剑法
运	运气	运动
寒	寒冷	寒风
领	领导	领头
枪	枪声	枪口
摸	摸了摸	摸摸
岁	岁月	岁数
象	象征	象征性
羽	羽毛	羽绒服
换	换上	换成
虎	虎子	虎视眈眈
副	副驾驶	副校长
察	察觉到	察觉
激	激动	激烈
论	论坛	论文
闪	闪过	闪电
元	元素	元气
网	网吧	网络
松	松开	松手
呆	呆呆	呆滞
呆	呆呆	呆滞
资	资料	资格
念	念头	念叨
调	调查	调侃
调	调查	调侃
袋	袋子	袋中
愿	愿意	愿望
枫	枫叶	枫林
节	节奏	节目
讲	讲台	讲话
怀	怀疑	怀里
故	故事	故意
咱	咱们	咱俩
娘	娘娘	娘家
散	散发	散发出
雷	雷电	雷劈
啦	啦啦队	啦啦队员
顺	顺着	顺便
救	救命	救人
哭	哭泣	哭声
官	官方	官员
改	改变	改造
器	器官	器材
团	团队	团长
抬	抬头	抬起
观	观察	观看
聊	聊天	聊着
菜	菜刀	菜单
胡	胡乱	胡思乱想
费	费用	费力
奶	奶奶	奶茶
追	追求	追问
麻	麻烦	麻木
志	志远	志愿
香	香烟	香味
歌	歌曲	歌声
压	压力	压抑
恶	恶心	恶魔
恶	恶心	恶魔
忘	忘记	忘不了
树	树林	树上
景	景象	景色
掌	掌握	掌控
严	严肃	严重
局	局长	局面
座	座位	座椅
耳	耳朵	耳边
肉	肉体	肉眼
村	村里	村子
恐	恐怕	恐惧
挺	挺拔	挺不错
示	示意	示弱
吓	吓了一跳	吓人
吓	吓了一跳	吓人
戏	戏谑	戏弄
戏	戏谑	戏弄
存	存在	存款
俩	俩个	俩眼
导	导致	导演
基	基本	基本上
式	式样	式微
九	九点	九天
杰	杰克	杰作
烦	烦恼	烦躁
英	英雄	英语
狗	狗血	狗屁
约	约定	约会
翻	翻开	翻身
佛	佛祖	佛教
态	态度	态势
柳	柳树	柳眉
甚	甚至	甚至于
既	既然	既然如此
置	置信	置身于
舍	舍不得	舍友
迷	迷茫	迷迷糊糊
族	族长	族人
查	查看	查询
查	查看	查询
遇	遇到	遇见
统	统一	统统
组	组织	组成
弄	弄死	弄清楚
弄	弄死	弄清楚
曾	曾经	曾几何时
曾	曾经	曾几何时
嘿	嘿嘿	嘿嘿嘿
嘿	嘿嘿	嘿嘿嘿
摆	摆手	摆脱
腿	腿部	腿脚
眉	眉头	眉毛
仅	仅仅	仅仅只是
较	较为	较大
蓝	蓝色	蓝天
集	集团	集中
布	布满	布置
按	按照	按钮
药	药材	药剂
证	证明	证据
取	取出	取得
夫	夫人	夫妻
伸	伸手	伸出
牛	牛仔裤	牛奶
担	担心	担忧
幸	幸福	幸好
斗	斗争	斗气
料	料到	料理
宿	宿舍	宿主
宿	宿舍	宿主
支	支持	支撑
雅	雅典娜	雅静
止	止住	止不住
坏	坏人	坏事
蛋	蛋糕	蛋蛋
偷	偷偷	偷看
温	温柔	温暖
模	模样	模糊
毫	毫无	毫不犹豫
假	假装	假期
抽	抽烟	抽奖
懂	懂得	懂事
洗	洗漱	洗澡
炼	炼制	炼化
质	质量	质疑
隐	隐藏	隐隐
商	商量	商场
引	引起	引来
屋	屋里	屋子
架	架势	架子
傻	傻子	傻笑
负	负责	负担
短	短信	短发
食	食堂	食物
食	食堂	食物
层	层次	层层
欣	欣赏	欣慰
泪	泪水	泪流满面
技	技能	技术
齐	齐齐	齐声
价	价格	价值
卖	卖掉	卖力
闹	闹钟	闹事
威	威胁	威力
奈	奈何	奈何桥
沈	沈默	沈家
沈	沈默	沈家
宁	宁静	宁愿
铁	铁门	铁棍
退	退出	退学
忽	忽然	忽略
谈	谈话	谈恋爱
堂	堂堂	堂哥
余	余光	余地
画	画面	画画
猛	猛地	猛然
福	福利	福伯
叹	叹息	叹气
洛	洛阳	洛城
斯	斯文	斯斯文文
魂	魂魄	魂飞魄散
愣	愣住	愣愣
扬	扬起	扬长而去
展	展开	展现
境	境界	境地
墨	墨镜	墨迹
民	民警	民族
属	属于	属性
属	属于	属性
狼	狼狈	狼吞虎咽
狂	狂奔	狂风
巨	巨大	巨响
顶	顶级	顶尖
礼	礼貌	礼物
哼	哼哼	哼唱
卡	卡片	卡车
卡	卡片	卡车
哎	哎呀	哎哟
令	令人	令牌
昨	昨天	昨晚
承	承认	承受
具	具体	具有
草	草坪	草泥马
历	历史	历练
恩	恩爱	恩人
挥	挥手	挥舞
仿	仿佛	仿若
仙	仙人	仙界
骂	骂人	骂骂咧咧
普	普通	普通人
帅	帅气	帅哥
兵	兵器	兵团
义	义气	义务
阴	阴沉	阴影
闻	闻言	闻到
休	休息	休闲
释	释放	释然
疼	疼痛	疼爱
状	状态	状况
紫	紫色	紫光
窗	窗外	窗户
挂	挂断	挂掉
产	产生	产品
联	联系	联盟
克	克制	克拉
忆	忆起	忆往昔
伟	伟大	伟哥
演	演员	演讲
升	升级	升起
弹	弹性	弹幕
弹	弹性	弹幕
街	街道	街上
杯	杯子	杯酒
秘	秘密	秘书
秘	秘密	秘书
造	造成	造型
密	密码	密密麻麻
独	独自	独立
德	德行	德国
旧	旧金山	旧书
举	举起	举动
柔	柔软	柔和
刺	刺激	刺眼
弱	弱小	弱点
厉	厉害	厉声
北	北京	北方
透	透过	透露
助	助理	助手
肩	肩膀	肩上
科	科技	科学
震	震惊	震撼
养	养成	养活
野	野兽	野猪
鱼	鱼儿	鱼塘
躺	躺倒	躺椅
沙	沙发	沙哑
卫	卫生间	卫生
搞	搞定	搞笑
议	议论	议论纷纷
划	划过	划破
社	社会	社团
汉	汉子	汉语
致	致命	致远
尔	尔虞我诈	尔后
坚	坚持	坚定
劲	劲儿	劲风
握	握住	握紧
慕	慕容	慕容雪
尘	尘土	尘埃
训	训练	训斥
值	值得	值钱
称	称呼	称为
春	春天	春节
控	控制	控制不了
读	读书	读者
秋	秋天	秋风
脱	脱离	脱掉
餐	餐厅	餐馆
盘	盘子	盘古
专	专业	专门
套	套路	套装
碎	碎片	碎裂
究	究竟	究其原因
盯	盯上	盯住
厅	厅堂	厅长
笔	笔记本	笔直
姑	姑娘	姑姑
土	土地	土豪
藏	藏獒	藏身
藏	藏獒	藏身
额	额头	额外
逸	逸仙	逸夫
胸	胸口	胸前
章	章节	章鱼
介	介绍	介意
爆	爆发	爆炸
付	付出	付钱
幕	幕后	幕布
惑	惑乱	惑众
欧	欧阳	欧洲
郑	郑重	郑重其事
纸	纸条	纸巾
镜	镜子	镜头
泽	泽西	泽被
舒	舒服	舒适
案	案子	案件
禁	禁止	禁不住
陪	陪伴	陪陪
虚	虚空	虚弱
险	险些	险恶
宋	宋朝	宋明
呜	呜呜	呜咽
豪	豪华	豪爽
园	园子	园长
贵	贵族	贵重
据	据说	据我所知
图	图书馆	图案
良	良久	良好
辈	辈分	辈子
剩	剩下	剩余
尸	尸体	尸骨
墙	墙上	墙壁
秀	秀发	秀气
皱	皱眉	皱着眉头
择	择偶	择日
择	择偶	择日
辆	辆车	辆次
骨	骨头	骨骼
躲	躲过	躲避
兰	兰博基尼	兰花
逃	逃跑	逃离
碰	碰到	碰上
灯	灯光	灯火
补	补充	补偿
撞	撞击	撞死
富	富贵	富裕
银	银行	银行卡
田	田野	田地
舞	舞台	舞蹈
标	标准	标志
波	波动	波澜
材	材料	材质
昊	昊天	昊天罔极
印	印象	印记
攻	攻击	攻势
烈	烈日	烈火
投	投入	投资
牙	牙齿	牙刷
智	智商	智慧
否	否则	否定
否	否则	否定
闭	闭上眼睛	闭嘴
洋	洋溢着	洋洋
纪	纪念	纪律
寻	寻找	寻常
啥	啥事	啥时候
剧	剧烈	剧情
环	环境	环绕
喂	喂喂	喂养
俊	俊俏	俊美
婆	婆婆	婆娘
漂	漂亮	漂浮
擦	擦拭	擦擦
派	派出所	派出
趣	趣事	趣味
束	束缚	束手无策
佳	佳佳	佳人
妖	妖怪	妖孽
累	累死	累赘
吐	吐出	吐血
纷	纷纷	纷飞
永	永远	永恒
估	估计	估摸
牌	牌子	牌匾
圈	圈子	圈子里
圈	圈子	圈子里
颜	颜色	颜面
暴	暴露	暴力
惜	惜字如金	惜惜
暴	暴露	暴力
君	君子	君王
遍	遍布	遍地
票	票子	票房
型	型号	型态
争	争取	争吵
疯	疯狂	疯子
临	临时	临近
端	端木	端详
某	某个	某些
婷	婷婷	婷婷玉立
废	废话	废物
参	参加	参与
参	参加	参与
河	河边	河里
弃	弃子	弃婴
借	借口	借着
仔	仔细	仔细观察
菲	菲尔	菲律宾
唯	唯一	唯有
源	源头	源源不断
封	封印	封面
须	须臾	须菩提
拥	拥有	拥抱
验	验证	验尸
挑	挑战	挑衅
索	索性	索索
毅	毅力	毅然
恨	恨不得	恨铁不成钢
硬	硬是	硬生生
滚	滚蛋	滚滚
奋	奋斗	奋力
胜	胜利	胜负
责	责任	责怪
丢	丢人	丢下
肖	肖扬	肖恩
杂	杂志	杂乱
晴	晴天	晴朗
逼	逼近	逼迫
码	码字	码头
货	货车	货物
守	守护	守卫
适	适合	适应
配	配合	配置
适	适合	适应
唱	唱歌	唱片
广	广场	广告
广	广场	广告
咬	咬牙	咬牙切齿
杜	杜宇	杜康
丹	丹田	丹药
婚	婚礼	婚姻
帝	帝国	帝王
曲	曲线	曲子
腰	腰间	腰部
规	规矩	规定
滴	滴滴	滴答
犹	犹豫	犹如
败	败家	败类
悠	悠闲	悠悠
糊	糊涂	糊弄
迎	迎接	迎来
油	油门	油条
茶	茶几	茶杯
户	户口	户外
屁	屁股	屁事
聚	聚集	聚会
设	设计	设定
浪	浪费	浪漫
操	操场	操作
赛	赛车	赛场
睁	睁开	睁开眼睛
谓	谓之	谓语
危	危险	危机
莉	莉莉	莉莉丝
射	射击	射入
馆	馆子	馆主
悉	悉心	悉数
涛	涛声	涛澜
鼻	鼻子	鼻梁
兽	兽医	兽皮
毒	毒蛇	毒品
绍	绍兴	绍武
治	治疗	治病
瓶	瓶子	瓶颈
权	权利	权限
朱	朱雀	朱砂
恋	恋爱	恋人
鸡	鸡蛋	鸡皮疙瘩
诗	诗人	诗歌
递	递给	递过来
讶	讶异	讶然
防	防御	防止
讨	讨厌	讨论
洞	洞口	洞穴
吼	吼道	吼叫
勇	勇气	勇敢
幻	幻想	幻觉
瞪	瞪眼	瞪起
彩	彩票	彩虹
梁	梁山	梁平
罢	罢了	罢休
扫	扫视	扫描
汗	汗水	汗珠
奔	奔跑	奔驰
妇	妇女	妇人
鲜	鲜血	鲜红
纯	纯洁	纯粹
凉	凉气	凉意
素	素质	素养
锋	锋利	锋芒
冒	冒出来	冒险
辉	辉煌	辉映
迹	迹象	迹线
项	项目	项链
丁	丁丁	丁香
丁	丁丁	丁香
职	职业	职位
愤	愤怒	愤愤
努	努力	努力学习
罪	罪恶	罪犯
爽	爽快	爽朗
触	触动	触摸
颗	颗粒	颗粒无收
貌	貌似	貌美
孤	孤独	孤儿院
郭	郭敬明	郭美美
雄	雄厚	雄伟
概	概念	概率
距	距离	距今
抢	抢劫	抢救
傅	傅先生	傅作义
缘	缘故	缘分
烧	烧烤	烧饼
凯	凯文	凯瑟琳
盖	盖住	盖子
炎	炎热	炎黄
琪	琪琪	琪花
善	善良	善意
腾	腾飞	腾空
闲	闲聊	闲着
徒	徒弟	徒儿
巧	巧合	巧克力
敌	敌人	敌意
拾	拾起	拾掇
免	免费	免得
伴	伴随	伴奏
闷	闷热	闷响
稍	稍微	稍稍
扭	扭头	扭曲
倩	倩影	倩女幽魂
秒	秒钟	秒杀
伯	伯伯	伯父
零	零食	零花钱
凝	凝聚	凝重
灭	灭亡	灭绝
飘	飘逸	飘荡
略	略显	略带
铭	铭记	铭文
软	软件	软软
悄	悄悄	悄悄的
挡	挡住	挡不住
轮	轮回	轮廓
川	川流不息	川静香
番	番茄	番薯
优	优秀	优雅
番	番茄	番薯
膀	膀子	膀大腰圆
膀	膀子	膀大腰圆
迟	迟到	迟疑
犯	犯罪	犯人
漫	漫长	漫画
晃	晃动	晃晃悠悠
绿	绿色	绿光
吹	吹牛	吹嘘
拜	拜托	拜拜
残	残酷	残忍
扑	扑通	扑面而来
玄	玄武	玄妙
董	董事长	董事
惯	惯性	惯例
诺	诺基亚	诺言
启	启动	启明
探	探索	探出
猫	猫咪	猫猫
妙	妙龄少女	妙手
偏	偏偏	偏僻
亚	亚洲	亚军
宫	宫殿	宫廷
傲	傲气	傲慢
珠	珠子	珠宝
丫	丫头	丫丫
灰	灰色	灰尘
肚	肚子	肚皮
镇	镇上	镇定
颤	颤抖	颤动
颤	颤抖	颤动
敬	敬请	敬畏
圆	圆形	圆圆的
昏	昏迷	昏暗
猜	猜测	猜想
咳	咳嗽	咳嗽声
咳	咳嗽	咳嗽声
厚	厚厚的	厚重
皇	皇帝	皇甫
移	移动	移开
粉	粉丝	粉色
维	维持	维护
博	博士	博物馆
附	附近	附和
尖	尖叫	尖锐
抖	抖动	抖动着
托	托人	托盘
限	限制	限量版
范	范围	范畴
臂	臂膀	臂力
娜	娜娜	娜塔莎
爬	爬起来	爬山
稳	稳定	稳重
奖	奖励	奖金
诚	诚恳	诚实
娇	娇小	娇羞
归	归来	归于
圣	圣人	圣地
共	共同	共有
欲	欲望	欲哭无泪
际	际遇	际会
输	输入	输给
虑	虑无不周	
敲	敲门	敲门声
燕	燕京	燕子
绩	绩效	绩溪
陌	陌生	陌生人
霸	霸气	霸道
欺	欺负	欺骗
慌	慌乱	慌张
扔	扔掉	扔下
误	误会	误解
惹	惹事	惹不起
获	获得	获取
朵	朵朵	朵花
研	研究	研究生
姜	姜文	姜子牙
姨	姨妈	姨夫
凭	凭借	凭着
晕	晕倒	晕过去
翼	翼手龙	翼翼
壮	壮汉	壮硕
京	京城	京都
敏	敏捷	敏感
骗	骗子	骗人
蒙	蒙面	蒙面人
幽	幽幽	幽灵
效	效果	效率
森	森林	森然
彻	彻底	彻彻底底
邪	邪恶	邪气
邪	邪恶	邪气
玲	玲珑	玲玲
省	省城	省会
省	省城	省会
琳	琳娜	琳琅满目
怨	怨气	怨恨
炸	炸弹	炸开
鹏	鹏飞	鹏程
测	测试	测验
折	折磨	折腾
折	折磨	折腾
梅	梅花	梅子
浑	浑身	浑身上下
搭	搭理	搭讪
惨	惨叫	惨白
暖	暖暖的	暖流
洁	洁白	洁癖
瑶	瑶池	瑶琳
童	童年	童话
苍	苍白	苍老
艺	艺术	艺人
嘻	嘻嘻	嘻嘻哈哈
砸	砸死	砸出
健	健康	健壮
铃	铃声	铃声响起
绪	绪论	绪言
扶	扶住	扶起来
扎	扎进	扎根
扎	扎进	扎根
尊	尊敬	尊重
匆	匆匆	匆忙
沐	沐阳	沐浴
鸣	鸣谢	鸣叫
甜	甜美	甜蜜
尼	尼玛	尼克
租	租房	租住
椅	椅子	椅背
委	委屈	委员
阶	阶段	阶梯
卷	卷子	卷起
尴	尴尬	尴尬事
潇	潇洒	潇潇
薇	薇薇安	薇诺娜
戴	戴眼镜	戴维斯
净	净化	净土
政	政府	政治
仇	仇恨	仇人
仇	仇恨	仇人
猪	猪头	猪肉
掏	掏出	掏钱
悲	悲伤	悲剧
浮	浮现	浮云
孔	孔明	孔子
羞	羞涩	羞辱
歉	歉意	歉疚
乌	乌拉	乌黑
财	财富	财产
创	创造	创作
胆	胆子	胆小
监	监狱	监控
唉	唉声叹气	唉呀
荡	荡漾	荡然无存
醉	醉酒	醉意
录	录取	录像
隔	隔壁	隔离
孟	孟子	孟婆汤
迅	迅速	迅猛
亡	亡灵	亡魂
育	育人	育才
尚	尚未	尚可
织	织女	织成
康	康复	康泰
晶	晶莹	晶晶
踢	踢飞	踢开
恢	恢复	恢复正常
扯	扯淡	扯开
箱	箱子	箱包
拖	拖鞋	拖拉机
挣	挣扎	挣脱
降	降临	降低
降	降临	降低
史	史诗	史密斯
裤	裤子	裤兜
轰	轰鸣	轰然
涵	涵养	涵盖
尾	尾巴	尾随
尾	尾巴	尾随
侧	侧身	侧面
侧	侧身	侧面
侧	侧身	侧面
互	互相	互联网
磊	磊磊	磊落
芒	芒果	芒果树
拒	拒绝	拒之门外
湖	湖边	湖面
预	预感	预料
避	避免	避开
乡	乡下	乡村
馨	馨香	馨心
庄	庄园	庄严
耐	耐心	耐不住
壁	壁画	壁上
拼	拼命	拼搏
裂	裂缝	裂开
抗	抗议	抗拒
抹	抹杀	抹布
妍	妍妍	妍丽
懒	懒得	懒腰
祖	祖宗	祖国
锁	锁定	锁上
凶	凶手	凶狠
堆	堆满	堆积
施	施展	施主
缺	缺少	缺点
困	困难	困惑
贝	贝尔	贝壳
洪	洪荒	洪水
慰	慰藉	慰问
暂	暂时	暂且
鼓	鼓励	鼓掌
插	插入	插进
符	符合	符号
蛇	蛇皮袋	蛇头
蛇	蛇皮袋	蛇头
乖	乖乖	乖巧
积	积分	积蓄
琴	琴声	琴弦
萌	萌生	萌芽
庭	庭院	庭审
赚	赚钱	赚取
赚	赚钱	赚取
鞋	鞋子	鞋底
冬	冬天	冬季
卧	卧室	卧槽
啪	啪啪	啪嗒
熊	熊猫	熊熊
私	私人	私下
梯	梯子	梯田
瘦	瘦弱	瘦小
赏	赏金	赏心悦目
农	农村	农民
饿	饿死	饿狼
甩	甩开	甩头
陷	陷入	陷阱
贴	贴着	贴身
荣	荣幸	荣耀
耀	耀眼	耀武扬威
营	营养	营业
赌	赌场	赌博
豫	豫州	豫南
悔	悔恨	悔过
庆	庆幸	庆祝
厂	厂里	厂子
厂	厂里	厂子
盛	盛开	盛夏
盛	盛开	盛夏
姓	姓名	姓氏
脏	脏兮兮	脏话
磨	磨练	磨蹭
宣	宣布	宣传
厨	厨房	厨师
尤	尤其	尤物
占	占据	占领
府	府邸	府上
针	针对	针灸
检	检查	检测
悦	悦耳	悦来
含	含义	含笑
脖	脖子	脖颈
郁	郁闷	郁郁葱葱
辛	辛苦	辛辛苦苦
播	播放	播报
仁	仁慈	仁兄
哲	哲学	哲理
浓	浓浓的	浓郁
碗	碗筷	碗面
劳	劳资	劳动
吵	吵醒	吵架
增	增加	增长
泡	泡妞	泡面
琐	琐琐碎碎	琐事
亦	亦然	亦可
甲	甲板	甲鱼
艾	艾伦	艾迪
季	季节	季末
艾	艾伦	艾迪
伊	伊人	伊东
横	横扫	横行
怜	怜悯	怜惜
偶	偶尔	偶然
旭	旭东	旭日
词	词语	词汇
踏	踏上	踏入
夕	夕阳	夕阳西下
雾	雾气	雾水
眯	眯着	眯着眼
仍	仍然	仍旧
享	享受	享用
挤	挤出	挤满
惧	惧怕	惧色
脉	脉搏	脉络
悟	悟空	悟性
戒	戒指	戒备
粗	粗气	粗糙
鸟	鸟儿	鸟蛋
鸟	鸟儿	鸟蛋
绕	绕过	绕道
摔	摔倒	摔死
铺	铺垫	铺满
庞	庞大	庞然大物
吞	吞噬	吞吞吐吐
烂	烂泥	烂摊子
乔	乔治	乔家
袭	袭击	袭警
刷	刷牙	刷刷
冥	冥王	冥界
爹	爹娘	爹妈
楠	楠木	楠竹
臭	臭小子	臭味
臭	臭小子	臭味
丧	丧尸	丧失
冯	冯宝宝	冯雪峰
痕	痕迹	痕记
替	替代	替身
莹	莹莹	莹润
厌	厌恶	厌烦
勾	勾起	勾勒
跃	跃起	跃跃欲试
宗	宗师	宗教
朗	朗诵	朗读
末	末日	末世
尝	尝试	尝尝
揉	揉捏	揉搓
阻	阻止	阻挡
率	率先	率领
率	率先	率领
液	液体	液晶电视
亏	亏了	亏待
忧	忧伤	忧郁
评	评价	评论
签	签约	签字
趴	趴在	趴下
凤	凤凰	凤毛麟角
染	染红	染成
缩	缩小	缩回
融	融合	融入
泰	泰山	泰国
屏	屏幕	屏障
屏	屏幕	屏障
钢	钢琴	钢铁
弯	弯腰	弯曲
婉	婉转	婉拒
款	款式	款款
慧	慧眼	慧根
列	列车	列表
艳	艳丽	艳遇
捂	捂着	捂住
执	执行	执着
纳	纳闷	纳米
娃	娃娃	娃子
滑	滑落	滑稽
涌	涌出	涌动
采	采访	采用
黎	黎明	黎川
赞	赞同	赞叹
旋	旋转	旋即
魏	魏晋	魏国
脆	脆弱	脆响
劫	劫匪	劫持
熙	熙熙攘攘	熙攘
遗	遗憾	遗忘
遗	遗憾	遗忘
撑	撑起	撑不住
姿	姿势	姿态
赢	赢得	赢家
丰	丰富	丰满
拦	拦住	拦下
狱	狱警	狱中
咯	咯咯	咯噔
咯	咯咯	咯噔
咯	咯咯	咯噔
咋	咋样	咋办
咋	咋样	咋办
薛	薛宝钗	薛定谔
宜	宜阳	宜人
摩	摩托车	摩擦
穷	穷人	穷小子
珍	珍惜	珍贵
船	船上	船长
穆	穆然	穆斯
骑	骑士	骑车
迫	迫不及待	迫切
夹	夹杂着	夹杂
夹	夹杂着	夹杂
旅	旅游	旅馆
县	县城	县里
汪	汪汪	汪洋
扰	扰乱	扰人清梦
盒	盒子	盒饭
律	律师	律动
屈	屈服	屈辱
聪	聪明	聪明人
遥	遥远	遥控器
怡	怡然	怡和
焦	焦急	焦虑
溜	溜达	溜走
唇	唇角	唇红齿白
坑	坑人	坑坑洼洼
妻	妻子	妻儿
编	编辑	编号
驶	驶去	驶来
塞	塞进	塞满
撒	撒娇	撒谎
肃	肃穆	肃静
曹	曹操	曹丕
逐	逐渐	逐步
搬	搬家	搬走
踪	踪影	踪迹
茫	茫然	茫茫
跪	跪下	跪倒
判	判断	判官
喃	喃喃	喃喃自语
蒋	蒋家	蒋介石
栋	栋梁	栋梁之才
摊	摊位	摊子
龄	龄期	
篮	篮球	篮球场
嘟	嘟囔	嘟嘟
泥	泥土	泥巴
吉	吉他	吉利
倍	倍感	倍儿
倾	倾城	倾斜
喷	喷出	喷嚏
钻	钻进	钻石
掩	掩饰	掩盖
捏	捏住	捏紧
键	键盘	键子
竹	竹竿	竹林
络	络绎不绝	络腮胡
牵	牵挂	牵扯
岳	岳父	岳母
咕	咕咕	咕噜
瑞	瑞士	瑞文
豆	豆豆	豆腐
埋	埋怨	埋头
登	登上	登记
棍	棍子	棍棒
肤	肤色	肤浅
殊	殊不知	殊死
翔	翔宇	翔实
恭	恭喜	恭敬
眨	眨眼	眨巴
袁	袁枚	袁天罡
旦	旦夕	旦旦
佩	佩服	佩戴
帆	帆布鞋	帆布
拔	拔出	拔腿就跑
销	销售	销售员
仰	仰望	仰头
狐	狐狸	狐疑
嘲	嘲笑	嘲讽
嘲	嘲笑	嘲讽
萱	萱望	萱草
寂	寂静	寂寞
瞧	瞧瞧	瞧不起
逗	逗我	逗乐
池	池塘	池子
坤	坤包	坤宁宫
甘	甘心	甘愿
砰	砰砰	砰然
燃	燃烧	燃起
席	席卷	席子
哇	哇哇	哇塞
振	振国	振华
叮	叮嘱	叮咚
稀	稀罕	稀少
嘉	嘉宾	嘉华
瓜	瓜子脸	瓜子
玛	玛丽	玛莎拉蒂
汤	汤姆	汤圆
汤	汤姆	汤圆
嫣	嫣然	嫣红
踩	踩到	踩油门
趁	趁着	趁机
喘	喘气	喘息
痴	痴迷	痴痴
谷	谷底	谷子
劝	劝说	劝阻
谷	谷底	谷子
纹	纹身	纹路
驾	驾驶	驾驶座
允	允许	允诺
亿	亿万	亿美元
供	供奉	供应
僵	僵尸	僵硬
芳	芳香	芳心
颖	颖慧	颖上
妮	妮子	妮儿
域	域外	域名
宽	宽大	宽敞
恼	恼怒	恼火
沫	沫儿	沫子
鑫	鑫茂	
肥	肥胖	肥肉
询	询问	询问笔录
拨	拨通	拨打
逛	逛街	逛逛
薄	薄薄的	薄弱
版	版本	版权
厕	厕所	厕所间
途	途中	途径
批	批评	批准
蹲	蹲下	蹲下来
蹲	蹲下	蹲下来
恒	恒星	恒心
御	御用	御医
氛	氛围	氛雾
岩	岩石	岩浆
宏	宏伟	宏图
典	典型	典雅
毁	毁灭	毁掉
祸	祸害	祸水
岚	岚县	岚皋
夺	夺走	夺取
猴	猴子	猴儿
胳	胳膊	胳膊肘
祝	祝福	祝贺
舅	舅舅	舅妈
撇	撇嘴	撇撇嘴
潜	潜力	潜意识
欠	欠揍	欠下
缠	缠绕	缠绵
迪	迪厅	迪拜
辣	辣椒	辣妹
耗	耗子	耗费
航	航班	航空
镖	镖局	镖师
媚	媚眼	媚笑
泉	泉水	泉眼
岛	岛国	岛上
抵	抵抗	抵挡
币	币种	币制
郎	郎中	郎才女貌
堪	堪称	堪忧
咧	咧嘴	咧着
酸	酸痛	酸楚
桃	桃花	桃子
焰	焰火	焰火晚会
瞎	瞎子	瞎说
咖	咖啡	咖啡厅
咖	咖啡	咖啡厅
例	例外	例如
购	购买	购物
账	账号	账户
夸	夸张	夸奖
曼	曼妙	曼哈顿
遭	遭遇	遭到
羊	羊皮	羊肉
奥	奥迪	奥特曼
损	损失	损坏
征	征服	征兆
唤	唤醒	唤作
蹭	蹭蹬	
赫	赫然	赫赫有名
裙	裙子	裙摆
柜	柜台	柜子
柜	柜台	柜子
载	载体	载入
锅	锅盖	锅碗瓢盆
辞	辞职	辞退
扣	扣子	扣除
寝	寝室	寝宫
伏	伏羲	伏笔
棒	棒棒糖	棒子
猎	猎人	猎物
湿	湿润	湿透
咽	咽下	咽喉
伍	伍子胥	伍拾
皓	皓月	皓然
延	延伸	延续
库	库里	库房
挠	挠头	挠痒痒
俗	俗话说	俗称
牧	牧场	牧师
映	映入眼帘	映入
槽	槽牙	槽糕
愧	愧疚	愧对
频	频繁	频道
荒	荒废	荒唐
吻	吻合	吻上了
汽	汽车	汽车站
舌	舌头	舌尖
虫	虫子	虫鸣
莲	莲花	莲蓬
授	授权	授课
贤	贤惠	贤者
档	档案	档次
捡	捡起	捡起来
仪	仪器	仪式
吕	吕布	吕洞宾
赤	赤裸裸	赤红
鸿	鸿蒙	鸿文
桥	桥段	桥下
啸	啸声	啸虎
咚	咚咚	
诸	诸葛	诸多
撕	撕裂	撕心裂肺
彼	彼此	彼岸
繁	繁华	繁星
繁	繁华	繁星
浅	浅浅的	浅笑
浅	浅浅的	浅笑
啡	啡厅	
朴	朴素	朴实
兮	兮兮	
窝	窝囊	窝囊废
赖	赖床	赖账
饱	饱满	饱嗝
炮	炮弹	炮灰
炮	炮弹	炮灰
洒	洒脱	洒落
筑	筑基	筑起
润	润泽	润滑
乘	乘客	乘坐
乘	乘客	乘坐
塔	塔米	塔顶
搜	搜索	搜寻
饰	饰品	饰演
肌	肌肉	肌肤
协	协会	协议
呃	呃逆	
缝	缝隙	缝合
减	减少	减肥
屑	屑意	
挨	挨打	挨着
励	励志	励精图治
砍	砍刀	砍死
绑	绑定	绑架
鼠	鼠标	鼠辈
抛	抛弃	抛开
耍	耍赖	耍流氓
嫌	嫌弃	嫌疑人
锐	锐利	锐气
饶	饶命	饶有兴趣
丈	丈夫	丈母娘
扮	扮演	扮演着
州	州市	州长
罚	罚站	罚款
玻	玻璃	玻璃窗
扇	扇门	扇子
眸	眸子	
蛮	蛮横	蛮子
氏	氏族	氏家谱
氏	氏族	氏家谱
疗	疗伤	疗养院
济	济南	济公
瞳	瞳孔	瞳仁
售	售票员	售价
澡	澡堂	澡堂子
郝	郝老板	郝老爷
珊	珊瑚	珊瑚礁
罩	罩杯	罩住
哀	哀嚎	哀求
漠	漠然	漠视
鄙	鄙视	鄙夷
兔	兔子	兔崽子
益	益民	益处
祥	祥和	祥云
荐	荐举	荐贤
滋	滋味	滋润
斤	斤斤计较	斤两
径	径直	径自
纠	纠结	纠缠
潘	潘多拉	潘安
趟	趟浑水	趟水
宾	宾馆	宾利
串	串门	串联
妞	妞妞	妞儿
泛	泛起	泛红
鹰	鹰眼	鹰钩鼻
诡	诡异	诡秘
抚	抚摸	抚养
柱	柱子	柱状
幅	幅度	幅员辽阔
踹	踹出去	
汇	汇报	汇聚
糟	糟糕	糟蹋
溪	溪水	溪流
苗	苗条	苗子
歪	歪歪	歪着头
核	核心	核桃
吊	吊儿郎当	吊灯
卓	卓越	卓然
催	催促	催眠
芸	芸芸	芸芸众生
疲	疲惫	疲倦
姚	姚明	姚安
殿	殿下	殿堂
奏	奏效	奏响
腹	腹部	腹诽
添	添加	添麻烦
忠	忠诚	忠实
链	链子	链接
侠	侠客	侠义
耸	耸了耸肩	耸耸肩
卵	卵石	卵子
脾	脾气	脾气好
摄	摄像头	摄像机
烤	烤肉	烤串
企	企业	企图
促	促使	促进
牢	牢牢	牢房
逆	逆转	逆流
嫩	嫩嫩的	嫩白
纵	纵横	纵身
固	固定	固执
彤	彤云	彤云密布
箭	箭头	箭矢
迈	迈着	迈出
伦	伦敦	伦理
盟	盟主	盟友
蜜	蜜蜂	蜜糖
订	订阅	订婚
谋	谋杀	谋生
贺	贺喜	贺卡
审	审核	审讯
胁	胁迫	胁持
葛	葛云飞	葛根
饮	饮料	饮食
括	括号	括弧
括	括号	括弧
拐	拐杖	拐角
嘀	嘀咕	嘀嘀
措	措手不及	措施
佑	佑德	佑护
愁	愁眉苦脸	愁容
魅	魅力	魅惑
爪	爪子	爪牙
糖	糖果	糖葫芦
悬	悬崖	悬浮
哄	哄笑	哄哄
酷	酷酷	酷热
漆	漆黑	漆黑一片
闯	闯荡	闯入
策	策划	策略
刑	刑警	刑天
潮	潮湿	潮流
遮	遮住	遮挡
齿	齿轮	齿间
丑	丑陋	丑恶
兜	兜里	兜帽
述	述说	述职
勉	勉强	勉为其难
钥	钥匙	钥匙孔
盈	盈盈	盈利
序	序列	序幕
斥	斥责	斥候
羡	羡慕	
渊	渊源	渊博
匙	匙子	匙里
匙	匙子	匙里
申	申请	申屠
霜	霜雪	霜降
培	培养	培训
刹	刹车	刹那间
刹	刹车	刹那间
笨	笨蛋	笨拙
鲁	鲁莽	鲁迅
贾	贾宝玉	贾似道
贾	贾宝玉	贾似道
隆	隆起	隆重
姬	姬鹏飞	姬大哥
梓	梓潼	梓树
陶	陶醉	陶瓷
陶	陶醉	陶瓷
嚣	嚣张	嚣张气焰
堵	堵住	堵车
涩	涩味	涩滞
娱	娱乐	娱乐圈
弥	弥漫	弥补
贱	贱人	贱货
麦	麦克	麦克风
躯	躯体	躯壳
谅	谅解	谅山
袍	袍子	袍哥
井	井盖	井井有条
尹	尹志平	尹恩惠
枝	枝叶	枝头
咒	咒骂	咒语
笼	笼罩	笼子
乃	乃是	乃至
赔	赔偿	赔钱
予	予以	予取予求
颇	颇为	颇具
崔	崔判官	崔府君
蝶	蝶舞	蝶儿
央	央求	央视
魄	魄力	魄荡魂飞
魄	魄力	魄荡魂飞
魄	魄力	魄荡魂飞
寸	寸头	寸土寸金
灿	灿烂	灿若繁星
憋	憋屈	憋着
萝	萝卜	萝卜丝
幼	幼儿园	幼稚
忌	忌惮	忌讳
巷	巷子	巷口
巷	巷子	巷口
漏	漏出	漏洞
邀	邀请	邀请函
歹	歹徒	歹毒
泄	泄露	泄气
彪	彪悍	彪形大汉
涨	涨红	涨红了脸
霞	霞光	霞山
墓	墓碑	墓地
韵	韵味	韵诗
垃	垃圾	垃圾桶
涂	涂抹	涂山
霍	霍先生	霍然
召	召唤	召集
召	召唤	召集
裹	裹住	裹得
斜	斜眼	斜阳
构	构成	构思
泣	泣不成声	泣鬼神
邓	邓大人	邓丽君
讽	讽刺	讽喻
媳	媳妇	媳妇儿
拽	拽了起来	拽起来
拽	拽了起来	拽起来
挖	挖掘	挖出来
逝	逝去	逝世
袖	袖子	袖口
阅	阅读	阅历
疾	疾病	疾驰
呐	呐喊	呐喊声
斩	斩杀	斩钉截铁
刃	刃口	刃具
植	植物	植入
帽	帽子	帽檐
瑟	瑟瑟	瑟斯
巾	巾帼	巾帼不让须眉
坦	坦然	坦克
赋	赋予	赋诗
雕	雕刻	雕像
删	删除	删了
宅	宅子	宅院
诱	诱惑	诱人
恰	恰好	恰巧
嫂	嫂子	嫂嫂
岂	岂不是	岂能
截	截然不同	截然
愈	愈发	愈合
蹦	蹦蹦跳跳	蹦出
渣	渣滓	渣子
匪	匪徒	匪夷所思
莎	莎士比亚	莎拉
莎	莎士比亚	莎拉
厢	厢房	厢式
誓	誓言	誓死
嗓	嗓子	嗓音
崩	崩溃	崩塌
筋	筋骨	筋疲力尽
噗	噗嗤	噗通
柯	柯林	柯蒂斯
翠	翠绿	翠绿色
聂	聂远	聂荣
匕	匕首	匕鬯不惊
昂	昂贵	昂首挺胸
谭	谭家	谭新杰
吾	吾辈	吾主
衫	衫衣	衫裤
豹	豹子	豹纹
嫁	嫁给	嫁人
盗	盗版	盗墓
浴	浴室	浴巾
麟	麟儿	麟德
猥	猥琐	猥琐男
盾	盾牌	盾片
勤	勤奋	勤快
宙	宙斯	
诧	诧异	诧然
枚	枚举	枚举法
违	违背	违反
穴	穴位	穴道
贼	贼眉鼠眼	贼人
煞	煞气	煞白
骚	骚扰	骚动
裁	裁判	裁决
娟	娟子	娟秀
惠	惠顾	惠子
旗	旗下	旗袍
樱	樱花	樱桃
廊	廊道	廊桥
页	页面	页码
锦	锦囊	锦盒
详	详细	详情
硕	硕大	硕士
辱	辱骂	辱没
垂	垂下	垂头丧气
躁	躁动	躁动不安
榜	榜单	榜样
恍	恍惚	恍然大悟
卢	卢卡	卢卡斯
桶	桶子	桶装
搂	搂住	搂搂抱抱
劈	劈头盖脸	劈开
覆	覆盖	覆灭
捉	捉弄	捉住
啤	啤酒	啤酒瓶
割	割舍	割破
衡	衡量	衡山
讯	讯息	讯号
衬	衬衫	衬衣
冠	冠军	冠冕堂皇
描	描述	描写
篇	篇文章	篇章
吟	吟唱	吟诗
霖	霖生	霖雨
盆	盆子	盆栽
跌	跌倒	跌落
茹	茹毛饮血	茹素
艰	艰难	艰辛
勒	勒索	勒住
叨	叨叨	叨念
叨	叨叨	叨念
碍	碍于	碍事
棋	棋子	棋盘
俏	俏皮	俏丽
丛	丛林	丛生
孝	孝顺	孝敬
烁	烁烁	
啧	啧啧	啧啧称奇
冉	冉冉	冉冉升起
侯	侯爵	侯赛因
抑	抑制	抑郁
疤	疤痕	疤脸
茜	茜茜公主	茜草
茜	茜茜公主	茜草
洲	洲际	洲际导弹
砖	砖头	砖块
琦	琦玉县	
荷	荷尔蒙	荷花
哗	哗哗	哗啦啦
灾	灾难	灾祸
霄	霄汉	霄夜
矮	矮小	矮子
贪	贪婪	贪玩
返	返回	返修
廖	廖国强	廖先生
颊	颊骨	颊面
婶	婶婶	婶子
皆	皆知	皆大欢喜
沿	沿着	沿海
掐	掐着	掐住
沾	沾满	沾染
披	披肩	披着
仓	仓库	仓促
霉	霉运	霉味
奕	奕奕	
莱	莱克	莱斯
锻	锻炼	锻炼身体
挽	挽着	挽留
阁	阁下	阁楼
炒	炒菜	炒股
淋	淋漓尽致	淋湿
凳	凳子	
耻	耻辱	耻笑
腕	腕表	腕上
籍	籍贯	籍无名
矩	矩阵	矩形
拆	拆开	拆迁
拆	拆开	拆迁
竞	竞争	竞选
析	析出	析产
哑	哑巴	哑口无言
蓉	蓉蓉	蓉城
谦	谦虚	谦卑
宠	宠物	宠爱
眠	眠思梦想	眠药
邵	邵东	邵阳
腐	腐烂	腐蚀
慨	慨叹	慨然
捕	捕捉到	捕捉
胎	胎记	胎儿
糕	糕点	糕点店
戚	戚戚	戚继光
灌	灌输	灌木丛
桐	桐树	桐城
逍	逍遥	逍遥子
彬	彬彬有礼	彬彬
献	献给	献殷勤
桑	桑塔纳	桑拿
碧	碧绿	碧海
械	械斗	械弹
翘	翘起	翘着
渴	渴望	渴求
辑	辑录	辑要
侵	侵蚀	侵犯
瞒	瞒不过	瞒过
咔	咔嚓	咔哒
岸	岸边	岸上
沟	沟通	沟壑
捧	捧起	捧场
枯	枯燥	枯萎
氓	氓流	
邻	邻居	邻家
筒	筒子楼	筒子
驰	驰骋	驰名
妥	妥协	妥当
铜	铜钱	铜铃
坠	坠落	坠入
蔡	蔡伦	蔡夫人
愉	愉快	愉悦
谱	谱写	谱子
鼎	鼎盛	鼎鼎大名
嘶	嘶吼	嘶哑
乞	乞丐	乞讨
膝	膝盖	膝下
畏	畏惧	畏畏缩缩
契	契约	契合
契	契约	契合
熬	熬夜	熬到
杆	杆子	杆秤
绵	绵绵	绵延
奉	奉献	奉承
卦	卦象	卦辞
亭	亭子	亭亭玉立
筷	筷子	筷子巷
瞄	瞄准	瞄着
骄	骄傲	骄阳
睿	睿智	睿哲
畅	畅快	畅想
颠	颠簸	颠覆
噬	噬人鲨	噬脐莫及
玫	玫瑰	玫瑰花
抄	抄起	抄袭
寿	寿命	寿司
撤	撤退	撤离
痒	痒痒	痒酥酥
肆	肆无忌惮	肆意
叉	叉腰	叉子
卿	卿卿	卿卿我我
阔	阔别	阔少
苹	苹果	苹果树
填	填饱	填写
驱	驱使	驱散
姆	姆妈	姆指
党	党员	党委书记
怔	怔怔	怔住
瞅	瞅见	
竖	竖起	竖立
兑	兑换	兑现
均	均匀	均衡
症	症状	症结
旺	旺盛	旺旺
碌	碌碌无为	碌碌
慎	慎重	慎重考虑
虹	虹膜	虹桥
蠢	蠢蠢欲动	蠢货
虹	虹膜	虹桥
吱	吱吱	吱呀
吱	吱吱	吱呀
姥	姥姥	姥爷
姥	姥姥	姥爷
尿	尿裤子	尿急
绳	绳子	绳索
栏	栏杆	栏目
妆	妆扮	妆点
乾	乾坤	乾隆
乾	乾坤	乾隆
萍	萍水相逢	萍踪侠影
港	港口	港湾
崇	崇拜	崇尚
仗	仗义	仗势欺人
狸	狸猫	狸子
闺	闺女	闺房
吩	吩咐	
稿	稿子	稿费
嚷	嚷嚷	嚷起来
盼	盼望	盼望着
伐	伐木	伐毛洗髓
偿	偿还	偿命
辜	辜负	辜鸿铭
淑	淑女	淑芳
彭	彭山	彭长老
谨	谨慎	谨记
阎	阎王	阎罗王
贫	贫穷	贫道
殷	殷勤	殷红
邦	邦杰	邦国
帘	帘子	帘布
著	著名	著称
驳	驳回	驳斥
窜	窜出	窜进
摘	摘下	摘下来
慈	慈祥	慈爱
鹤	鹤立鸡群	鹤发童颜
巫	巫师	巫术
邹	邹城	邹家
跨	跨越	跨过
喉	喉咙	喉结
憾	憾事	憾动
佣	佣兵	佣人
嚎	嚎叫	嚎啕大哭
宴	宴会	宴席
寄	寄托	寄宿
瞥	瞥见	瞥一眼
刮	刮目相看	刮起
矿	矿泉水	矿泉水瓶
谎	谎言	谎话
婴	婴儿	婴孩
污	污染	污垢
础	础润而雨	础石
蚁	蚁后	蚁王
尺	尺寸	尺子
俱	俱乐部	俱全
侃	侃侃而谈	侃大山
坛	坛子	坛主
胃	胃口	胃部
萨	萨斯	萨尔
捷	捷径	捷达
柏	柏油路	柏油
柄	柄竹	柄政
柴	柴火	柴刀
腻	腻歪	腻味
扩	扩大	扩散
侣	侣伴	
嘱	嘱咐	嘱托
挪	挪动	挪开
涯	涯子	涯际
陵	陵墓	陵园
肿	肿胀	肿瘤
浸	浸湿	浸泡
腔	腔调	腔子
诀	诀窍	诀别
厦	厦门	厦大
厦	厦门	厦大
懵	懵懂	懵懵懂懂
辕	辕马	辕门
雀	雀跃	雀斑
访	访问	访客
拟	拟定	拟态
患	患者	患有
誉	誉为	誉满
矛	矛盾	矛头
彦	彦士	彦涵
暮	暮色	暮年
聘	聘请	聘用
伪	伪装	伪装成
悍	悍匪	悍马车
韦	韦小宝	韦小
瑰	瑰丽	瑰宝
瑜	瑜伽	瑜珈
晋	晋级	晋升
呈	呈现	呈现出
芊	芊芊	芊绵
漱	漱口	漱口水
媒	媒体	媒婆
棵	棵子	棵儿
翅	翅膀	翅翼
翰	翰墨	翰林
屠	屠杀	屠夫
巅	巅峰	巅峰状态
邱	邱少云	邱先生
稚	稚嫩	稚气
泼	泼妇	泼辣
娶	娶媳妇	娶妻生子
溢	溢出	溢于言表
辅	辅助	辅导员
姗	姗姗	姗姗来迟
璇	璇玑	璇宫
惫	惫懒	
斑	斑驳	斑白
饼	饼干	饼子
澈	澈底	澈底澄清
叠	叠好	叠加
塌	塌陷	塌下来
妒	妒忌	妒火
烫	烫伤	烫手
纤	纤细	纤纤
纤	纤细	纤纤
蒂	蒂斯	蒂娜
窃	窃窃私语	窃喜
惩	惩罚	惩戒
涉	涉及	涉猎
炫	炫耀	炫目
祭	祭坛	祭祀
虐	虐待	虐杀
辩	辩解	辩论
汐	汐止	
帐	帐篷	帐号
叛	叛逆	叛徒
鸭	鸭子	鸭舌帽
冻	冻结	冻得
腥	腥味	腥臭
躬	躬身	躬身行礼
肺	肺部	肺癌
障	障碍	障碍物
吁	吁吁	吁气
吁	吁吁	吁气
溃	溃散	溃烂
溃	溃散	溃烂
兼	兼职	兼任
澜	澜沧江	澜沧
靖	靖宇	靖康
津	津津有味	津津乐道
拎	拎包	拎下来
耽	耽误	耽搁
嗡	嗡嗡	嗡嗡作响
鉴	鉴定	鉴于
塑	塑料袋	塑料
锤	锤子	锤炼
嘎	嘎嘎	嘎吱
愕	愕然	愕视
册	册子	册封
藤	藤蔓	藤椅
丐	丐帮	丐幫
缕	缕缕	缕述
筹	筹码	筹备
臣	臣服	臣服于
狞	狞笑	狞恶
剪	剪刀	剪辑
嗨	嗨哟	
伞	伞兵	伞柄
昆	昆仑	昆虫
歇	歇斯底里	歇息
蕾	蕾丝	蕾期
援	援助	援手
舔	舔着	舔食
储	储存	储备
茂	茂密	茂盛
裸	裸露	裸奔
赐	赐予	赐给
讪	讪讪	讪笑
狮	狮子	狮吼
葬	葬礼	葬送
宛	宛如	宛若
磕	磕头	磕磕绊绊
冤	冤枉	冤家
掀	掀起	掀开
嫉	嫉妒	嫉恶如仇
蔓	蔓延	蔓延到
惕	惕厉	惕惧
蔓	蔓延	蔓延到
奸	奸笑	奸诈
喽	喽啰	喽罗
肠	肠子	肠胃
贯	贯穿	贯彻
叽	叽叽喳喳	叽叽
迁	迁移	迁就
凄	凄惨	凄凉
渡	渡劫	渡过
卑	卑微	卑鄙
龟	龟儿子	龟壳
龟	龟儿子	龟壳
龟	龟儿子	龟壳
暑	暑假	暑假作业
屎	屎壳郎	屎尿
俺	俺们	俺家
犬	犬吠	犬子
哆	哆嗦	哆哆嗦嗦
祈	祈祷	祈求
框	框架	框框
乏	乏味	乏力
嘘	嘘寒问暖	嘘声
嘘	嘘寒问暖	嘘声
魁	魁梧	魁首
妄	妄想	妄图
崖	崖壁	崖顶
疏	疏远	疏忽
凛	凛冽	凛然
唔	唔该晒	
噩	噩梦	噩耗
狙	狙击手	狙击枪
郊	郊区	郊外
朦	朦胧	朦朦胧胧
沸	沸腾	沸沸扬扬
滞	滞留	滞后
鞭	鞭子	鞭炮
粒	粒子	粒粒
蜂	蜂蜜	蜂拥
俯	俯卧撑	俯视
撼	撼动	撼天动地
瓦	瓦房	瓦片
夷	夷为平地	夷陵
胞	胞弟	胞胎
舟	舟车劳顿	舟山
鹿	鹿角	鹿鼎记
桂	桂花	桂花树
轨	轨迹	轨道
革	革命	革新
革	革命	革新
耶	耶稣	耶和华
颈	颈部	颈椎
颈	颈部	颈椎
勋	勋章	勋爵
嗤	嗤笑	嗤之以鼻
剂	剂量	剂子
瓷	瓷器	瓷砖
坡	坡度	坡顶
肢	肢体	肢解
哮	哮喘	哮喘病
鞠	鞠躬	鞠一躬
芷	芷江	芷江侗族自治县
甄	甄别	甄选
纱	纱布	纱窗
滩	滩涂	滩头
狰	狰狞	狰狞面目
炉	炉子	炉火纯青
闫	闫相闯	闫利军
秃	秃顶	秃头
煮	煮饭	煮熟
煌	煌煌	
罐	罐子	罐头
扛	扛着	扛起
扛	扛着	扛起
寺	寺庙	寺院
壶	壶里	壶盖
铮	铮铮	铮亮
嬉	嬉笑	嬉皮笑脸
雇	雇佣兵	雇主
囊	囊中羞涩	囊括
拢	拢共	拢络
奢	奢侈	奢华
弓	弓箭	弓着腰
勺	勺子	勺儿
绷	绷带	绷紧
钉	钉子	钉子户
侦	侦探	侦查
绽	绽放	绽开
壳	壳子	壳里
昌	昌盛	昌明
壳	壳子	壳里
枕	枕头	枕边
勃	勃然大怒	勃发
樊	樊城	樊笼
衍	衍生	衍化
庙	庙里	庙宇
琼	琼斯	琼瑶
蛛	蛛丝马迹	蛛网
逢	逢年过节	逢凶化吉
淘	淘汰	淘宝
搏	搏斗	搏击
诊	诊所	诊断
汹	汹涌	汹涌澎湃
瘫	瘫坐	瘫痪
巡	巡逻	巡视
嗽	嗽叭声	嗽口
菊	菊花	菊花茶
宵	宵夜	宵小
捅	捅破	捅进
噜	噜苏	噜嗦
碑	碑文	碑志
牲	牲口	牲畜
戈	戈壁	戈壁滩
卜	卜卦	卜算
宰	宰割	宰相
喧	喧闹	喧嚣
攀	攀爬	攀谈
棺	棺材	棺木
沁	沁人心脾	沁入
寓	寓意	寓言
仆	仆人	仆从
搓	搓手	搓衣板
俞	俞岱岩	俞飞鸿
俞	俞岱岩	俞飞鸿
崽	崽子	崽儿
耿	耿耿于怀	耿直
邢	邢台	邢先生
诞	诞生	诞辰
粮	粮食	粮票
芬	芬芳	芬达
喻	喻为	喻示
膛	膛线	
岗	岗位	岗亭
巍	巍峨	巍巍
届	届时	届满
匹	匹配	匹敌
咆	咆哮	咆哮声
衷	衷心	衷肠
凰	凰凤	
拇	拇指	拇趾
晒	晒太阳	晒干
磁	磁性	磁场
抿	抿嘴	抿着
贩	贩卖	贩子
循	循环	循声
湘	湘竹	湘西
扒	扒拉	扒开
扒	扒拉	扒开
隙	隙间	隙缝
旷	旷课	旷野
擎	擎天	擎天柱
押	押金	押送
栽	栽倒	栽培
堡	堡垒	堡主
堡	堡垒	堡主
削	削弱	削瘦
捣	捣乱	捣鼓
丸	丸子	丸药
篷	篷布	篷子
嗷	嗷嗷	嗷嗷叫
尧	尧舜	尧山
垫	垫底	垫子
畜	畜生	畜牲
畜	畜生	畜牲
怯	怯怯	怯生生
骤	骤然	骤变
揭	揭开	揭穿
僻	僻静	僻静处
奴	奴隶	奴才
鸦	鸦雀无声	鸦片
汁	汁液	汁水
蓄	蓄力	蓄势待发
傍	傍晚	傍边
蔽	蔽日	蔽体
鹅	鹅蛋脸	鹅卵石
僧	僧人	僧袍
蕴	蕴含	蕴含着
蹬	蹬蹬	蹬腿
憨	憨厚	憨笑
驴	驴子	驴肝肺
轿	轿车	轿子
楞	楞住	楞楞
琢	琢磨	琢磨不透
琢	琢磨	琢磨不透
酱	酱油	酱紫
沧	沧桑	沧海
虾	虾米	虾子
虾	虾米	虾子
蚂	蚂蚁	蚂蚱
孕	孕妇	孕育
怂	怂恿	
虞	虞美人	虞城
览	览胜	
茅	茅山	茅屋
侍	侍卫	侍者
弘	弘扬	弘一
寡	寡妇	寡人
麒	麒麟	麒麟山
丘	丘陵	丘比特
廉	廉价	廉洁
梭	梭子	梭哈
梨	梨花	梨花带雨
薪	薪水	薪资
拧	拧开	拧成
骆	骆驼	骆驼比
揪	揪住	揪心
裕	裕华	裕兴
骇	骇人	骇然
昭	昭示	昭君
孽	孽障	孽畜
翡	翡翠	翡翠台
弦	弦月	弦乐
舰	舰队	舰长
狡	狡黠	狡猾
梧	梧桐	梧桐树
溅	溅出	溅射
妃	妃子	妃嫔
综	综合	综艺节目
蓬	蓬松	蓬乱
岭	岭南	岭上
燥	燥热	燥动
债	债务	债主
滔	滔滔不绝	滔天
鳞	鳞片	鳞次栉比
咪	咪咪	咪咪叫
棚	棚子	棚户区
灼	灼热	灼烧
祁	祁阳	祁连
唠	唠叨	唠嗑
戳	戳穿	戳破
搅	搅拌	搅动
苟	苟延残喘	苟活
荆	荆棘	荆轲
帖	帖子	帖服
醋	醋意	醋溜
诈	诈骗	诈尸
狄	狄仁杰	狄更斯
芯	芯片	芯子
庸	庸俗	庸医
坟	坟墓	坟地
搁	搁置	搁浅
恳	恳求	恳请
笛	笛子	笛声
泳	泳池	泳衣
愚	愚蠢	愚人节
驻	驻足	驻扎
禹	禹城	禹县
擅	擅长	擅自
喳	喳喳	
喳	喳喳	
囔	囔囔	囔着
猩	猩红	猩猩
昧	昧着良心	昧良心
厮	厮杀	厮混
拘	拘谨	拘束
侄	侄子	侄女
劣	劣质	劣势
粥	粥饭	粥少僧多
嗖	嗖嗖	
邮	邮件	邮箱
兆	兆头	兆赫
泊	泊车	泊位
泊	泊车	泊位
蹈	蹈海	蹈火
辨	辨别	辨认
芝	芝麻	芝加哥
膜	膜拜	膜法
寥	寥寥	寥寥无几
倦	倦意	倦容
浆	浆糊	浆果
谐	谐音	谐波
芦	芦苇	芦苇荡
棉	棉花	棉袄
焕	焕发	焕然一新
缚	缚鸡之力	缚住
拂	拂面	拂尘
佐	佐野	佐藤
弧	弧度	弧线
陨	陨石	陨落
嚓	嚓嚓	
嚓	嚓嚓	
渺	渺小	渺茫
瞟	瞟向	瞟一眼
茗	茗茶	
蒸	蒸发	蒸笼
黯	黯然	黯淡
蔑	蔑视	蔑称
渔	渔船	渔民
督	督促	督察
衅	衅端	衅发萧墙
敞	敞开	敞篷
飙	飙车	飙升
茬	茬子	茬口
掠	掠过	掠夺
酬	酬劳	酬金
嗅	嗅到	嗅觉
厘	厘米	厘清
烛	烛光	烛火
啃	啃着	啃食
煎	煎熬	煎饼
粘	粘着	粘稠
粘	粘着	粘稠
忐	忐忑	忐忑不安
渗	渗出	渗透
唧	唧唧	唧唧喳喳
蝴	蝴蝶	蝴蝶结
呛	呛得	呛到
捞	捞起	捞鱼
殴	殴打	殴斗
携	携带	携手
哨	哨声	哨兵
梳	梳着	梳理
罕	罕见	罕有
淫	淫笑	淫威
橙	橙子	橙色
唬	唬住	唬人
唬	唬住	唬人
阮	阮士中	阮小七
舱	舱门	舱内
蚊	蚊子	蚊虫
漓	漓江	漓水
葱	葱花	葱葱
枉	枉费	枉死
蛊	蛊惑	蛊毒
塘	塘边	塘村
箫	箫声	箫管
焉	焉知非福	焉知
嚼	嚼舌根	嚼舌头
骷	骷髅	骷髅头
搐	搐动	搐搦
儒	儒雅	儒家
瘾	瘾君子	瘾头
呕	呕吐	呕吐物
跺	跺脚	跺跺脚
倚	倚靠在	倚天
胶	胶带	胶囊
揣	揣着	揣测
栗	栗子	栗色
杉	杉木	杉树
仲	仲夏	仲裁
妨	妨碍	妨害
茉	茉莉	茉莉花
钓	钓鱼	钓到
唾	唾沫	唾液
衰	衰老	衰竭
衰	衰老	衰竭
缸	缸子	缸盖
靓	靓丽	靓女
靓	靓丽	靓女
凸	凸起	凸显
倪	倪匡	倪云林
爵	爵士	爵位
翁	翁美玲	翁婿
茵	茵茵	茵陈
遵	遵守	遵循
牺	牺牲	牺牲品
嗒	嗒然若丧	
嗒	嗒然若丧	
逊	逊色	逊于
斧	斧头	斧子
淌	淌出	淌水
喇	喇叭	喇叭声
姻	姻缘	姻亲
蝎	蝎子	蝎虎
扳	扳机	扳指
竭	竭力	竭尽全力
摧	摧毁	摧残
蜘	蜘蛛	蜘蛛网
梵	梵天	梵音
峻	峻岭	峻峭
稻	稻草	稻田
胀	胀痛	胀大
敛	敛财	敛容
禽	禽兽	禽兽不如
逻	逻辑	逻辑思维
陡	陡然	陡峭
滨	滨海	滨江
攒	攒钱	攒动
攒	攒钱	攒动
淳	淳朴	淳于
焚	焚烧	焚身
拱	拱手	拱门
熏	熏陶	熏得
窍	窍门	窍取
绯	绯红	绯闻
翩	翩翩	翩翩起舞
茄	茄子	茄汁
茄	茄子	茄汁
熄	熄灭	熄灯
湾	湾里	湾子
浇	浇水	浇灌
雁	雁门关	雁城
贡	贡献	贡品
拯	拯救	拯民
擒	擒拿	擒住
喔	喔喔叫	
喔	喔喔叫	
兀	兀自	兀然
剥	剥夺	剥离
痞	痞子	痞里痞气
绰	绰号	绰绰有余
卸	卸下	卸载
狭	狭小	狭窄
钧	钧道	钧窑
睹	睹物思人	睹物思情
钞	钞票	钞本
杖	杖刑	
逮	逮到	逮住
敷	敷衍	敷衍了事
吭	吭声	吭哧
吭	吭声	吭哧
笙	笙歌	笙箫
瀚	瀚海	
祷	祷告	祷文
蔬	蔬菜	蔬菜水果
贸	贸然	贸易
顽	顽皮	顽强
奎	奎特	奎斯
翎	翎儿	翎子
哧	哧溜	哧哧
弊	弊端	弊病
揽	揽住	揽入
咸	咸菜	咸鱼
棱	棱角分明	棱角
恬	恬静	恬不知耻
帕	帕萨特	帕子
琉	琉璃	琉璃瓦
拭	拭去	拭目以待
穹	穹顶	穹苍
裴	裴元绍	裴多菲
蟒	蟒蛇	蟒袍
饥	饥饿	饥饿感
绘	绘画	绘制
钩	钩子	钩钩
婕	婕妤	
犀	犀利	犀牛
珂	珂罗版	
昔	昔日	昔年
潭	潭水	潭边
凹	凹凸	凹陷
擂	擂台	擂鼓
侮	侮辱	侮辱性
扁	扁担	扁平
扁	扁担	扁平
岔	岔开	岔路
馒	馒头	馒头山
涕	涕泪	涕零
絮	絮絮叨叨	絮叨
惶	惶恐	惶恐不安
贞	贞操	贞元
芙	芙蓉	芙蓉王
沃	沃尔玛	沃土
趋	趋势	趋于
懦	懦弱	懦夫
腮	腮帮子	腮帮
埃	埃及	埃菲尔铁塔
株	株式会社	株洲
贷	贷款	贷出
煤	煤矿	煤炭
葫	葫芦	葫芦娃
杭	杭州	杭城
盐	盐水	盐城
履	履行	履历
禅	禅房	禅院
禅	禅房	禅院
寨	寨子	寨主
毙	毙命	毙掉
搀	搀扶	搀扶着
肘	肘子	肘部
袜	袜子	袜业
淹	淹没	淹死
甫	甫士	甫志高
恤	恤衫	恤孤
陋	陋习	陋室
叭	叭叭	叭儿狗
佟	佟佳氏	佟湘玉
掰	掰开	掰断
瘪	瘪三	瘪嘴
蝇	蝇头	蝇头小利
砂	砂锅	砂石
廷	廷尉	廷长
琅	琅琅	琅嬛福地
译	译文	译名
髓	髓海	髓质
碟	碟片	碟子
嗔	嗔怪	嗔怒
艘	艘次	
倔	倔强	倔强地
踉	踉跄	踉踉跄跄
晌	晌午	
涡	涡轮	涡流
涡	涡轮	涡流
脯	脯氨酸	
脯	脯氨酸	
屉	屉子	
窥	窥视	窥探
绊	绊倒	绊子
辫	辫子	辫儿
撩	撩起	撩人
桀	桀桀	桀骜不驯
叙	叙述	叙旧
拓	拓展	拓宽
蜀	蜀山	蜀黍
詹	詹姆斯	詹姆士
菩	菩萨	菩提
逞	逞强	逞能
澄	澄清	澄澈
澄	澄清	澄澈
堕	堕落	堕入
坎	坎坷	坎儿
蚀	蚀刻	蚀本
疙	疙瘩	疙疙瘩瘩
晖	晖映	
悸	悸动	悸動
酿	酿成	酿造
妩	妩媚	妩媚动人
芽	芽儿	芽苞
盔	盔甲	盔帽
椒	椒盐	椒料
盲	盲目	盲人
骏	骏马	骏业
嘈	嘈杂	嘈杂声
绅	绅士	绅士风度
乍	乍一看	乍现
役	役使	役所
撸	撸子	
沦	沦落	沦为
涟	涟漪	涟涟
铠	铠甲	铠装
垮	垮掉	垮塌
勿	勿扰	勿近
赴	赴约	赴汤蹈火
乳	乳白色	乳臭未干
捆	捆绑	捆住
蜡	蜡烛	蜡黄
娥	娥眉	娥眉月
蜡	蜡烛	蜡黄
眩	眩晕	眩目
蔚	蔚蓝	蔚蓝色
蔚	蔚蓝	蔚蓝色
豁	豁出去	豁然开朗
乙	乙方	乙肝
暧	暧昧	暧昧关系
娴	娴熟	娴静
盏	盏灯	
颅	颅内	颅骨
伺	伺候	伺机
伺	伺候	伺机
龚	龚光杰	龚自珍
弗	弗兰克	弗拉德
黝	黝黑	黝暗
莽	莽撞	莽汉
崎	崎岖	崎岖不平
颓	颓废	颓然
暇	暇接	暇时
兢	兢兢业业	兢兢战战
绒	绒毛	绒布
漩	漩涡	漩流
肋	肋骨	肋间
肝	肝脏	肝癌
遁	遁入	遁走
戮	戮破	戮力
骁	骁勇	骁勇善战
荫	荫凉	荫庇
渠	渠道	渠水
嗜	嗜血	嗜好
懊	懊恼	懊悔
毯	毯子	
剔	剔除	剔透
酥	酥麻	酥软
炽	炽热	炽烈
践	践踏	践行
杠	杠杠	杠杆
浊	浊气	浊酒
窄	窄小	窄窄的
钮	钮祜禄	钮扣
桩	桩子	桩头
赠	赠送	赠与
诛	诛杀	诛灭
哽	哽咽	哽住
坪	坪上	坪地
枭	枭雄	枭首
蒲	蒲团	蒲扇
攘	攘攘	攘外必先安内
艇	艇长	艇员
朔	朔风	朔州
悚	悚然	悚惧
铐	铐起来	
绣	绣花	绣花针
汰	汰去	汰衣裳
诅	诅咒	诅骂
匀	匀称	匀速
惺	惺忪	惺惺相惜
溺	溺爱	溺水
螺	螺旋	螺丝
瘸	瘸子	瘸腿
遣	遣散	遣送
祟	祟高	
瓣	瓣膜	瓣膜病
碾	碾压	碾碎
杏	杏子	杏眼
棠	棠棣	棠梨
蟹	蟹黄	蟹肉
坊	坊间	坊肆
蛤	蛤蟆	蛤蟆镜
蛤	蛤蟆	蛤蟆镜
刁	刁难	刁蛮
慑	慑服	
脂	脂肪	脂粉
脊	脊背	脊梁
痹	痹症	痹证
霎	霎时	霎时间
挫	挫折	挫败
偌	偌大	
漪	漪澜	漪涟
霓	霓虹灯	霓虹
囚	囚犯	囚禁
葡	葡萄	葡萄酒
湛	湛蓝	湛卢
窟	窟窿	窟窿眼
掘	掘墓	掘进
褚	褚万里	褚时健
褚	褚万里	褚时健
仑	仑背	
辟	辟邪	辟谷
辟	辟邪	辟谷
蝉	蝉鸣	蝉儿
黛	黛安娜	黛绿
陀	陀螺	陀罗尼
棘	棘手	棘突
窒	窒息	窒息而死
饺	饺子	饺子馆
蔼	蔼蔼	蔼然
悻	悻悻	悻悻然
矫	矫情	矫健
癫	癫狂	癫痫
睫	睫毛	睫毛膏
徘	徘徊	徘徊者
惬	惬意	惬当
谣	谣言	谣传
浏	浏览	浏览器
栩	栩栩如生	栩栩
咏	咏春拳	咏春
檀	檀木	檀香
馈	馈赠	馈线
谑	谑浪笑敖	谑而不虐
膏	膏药	膏药旗
夭	夭折	夭寿
轴	轴承	轴心
蝠	蝠王	
薯	薯片	薯条
桦	桦林	桦树
沮	沮丧	沮洳
纲	纲要	纲领
亢	亢奋	亢龙有悔
萎	萎靡	萎缩
疫	疫苗	疫情
蜷	蜷缩	蜷曲
炯	炯炯有神	炯炯
巢	巢穴	巢里
尉	尉迟	尉迟恭
尉	尉迟	尉迟恭
苑	苑里	苑仙葩
霏	霏霏	霏霏细雨
侈	侈靡	侈谈
朽	朽木	朽木不可雕
亩	亩产	亩产量
氧	氧气	氧化
菱	菱形	菱角
禾	禾苗	禾田
聋	聋子	聋哑人
啼	啼哭	啼笑皆非
捶	捶打	捶背
讥	讥讽	讥笑
蹙	蹙眉	蹙额
眷	眷顾	眷恋
懈	懈怠	懈惰
炙	炙热	炙烤
捋	捋起	捋胳膊
崛	崛起	崛地而起
蹄	蹄子	蹄印
惭	惭愧	惭色
喋	喋喋不休	喋血
喋	喋喋不休	喋血
噼	噼里啪啦	噼啪
漾	漾濞	
癌	癌症	癌细胞
俄	俄罗斯	俄语
捐	捐款	捐赠
镶	镶嵌	镶着
敖	敖广	敖包
绞	绞尽脑汁	绞痛
猿	猿猴	猿人
镰	镰刀	镰刀状
鲨	鲨鱼	鲨鱼肉
憬	憬悟	憬然有悟
怠	怠慢	怠惰
憔	憔悴	
兹	兹曼	兹将
兹	兹曼	兹将
纽	纽约	纽扣
函	函数	函授
犊	犊子	犊鼻
晦	晦气	晦涩
悯	悯惜	
铲	铲子	铲除
惋	惋惜	惋叹
泠	泠然	
馅	馅饼	馅儿
挚	挚友	挚爱
熠	熠熠生辉	熠熠
掺	掺杂	掺和
谜	谜团	谜底
褪	褪去	褪色
烙	烙印	烙饼
缭	缭绕	缭乱
棕	棕色	棕熊
税	税收	税务局
肾	肾虚	肾上腺素
臀	臀部	臀围
晏	晏子	晏婴
柠	柠檬	柠檬水
菁	菁菁	菁华
蓦	蓦然	蓦地
檐	檐下	檐角
铅	铅笔	铅球
铅	铅笔	铅球
铛	铛铛	
铛	铛铛	
罡	罡风	
炭	炭火	炭炉
裆	裆部	
褂	褂子	
蝙	蝙蝠	蝙蝠侠
稽	稽首	稽查
稽	稽首	稽查
葵	葵花宝典	葵花
蹑	蹑手蹑脚	蹑着
滥	滥用	滥竽充数
隶	隶属于	隶属
澳	澳门	澳洲
撂	撂倒	撂下
粪	粪便	粪坑
鲍	鲍鱼	鲍威尔
浦	浦东	浦江
刊	刊登	刊物
锈	锈迹斑斑	锈迹
蛙	蛙跳	蛙鸣
黏	黏在	黏糊糊
憧	憧憬	憧憬未来
遂	遂即	遂愿
徽	徽章	徽州
翟	翟志刚	翟乃社
翟	翟志刚	翟乃社
菇	菇类	
廓	廓落	廓尔喀
秩	秩序	秩序井然
顷	顷刻间	顷刻
鸽	鸽子	鸽子笼
怅	怅然若失	怅然
崭	崭新	崭露头角
吆	吆喝	吆喝声
钦	钦佩	钦点
奄	奄奄一息	奄奄
慵	慵懒	慵懶
觅	觅食	觅得
竿	竿子	竿头
噎	噎着	噎住
拌	拌嘴	拌面
殖	殖民	殖民地
殖	殖民	殖民地
幺	幺幺小丑	
诵	诵读	诵经
拙	拙劣	拙作
抠	抠门	抠出来
汝	汝矣岛	汝阳
瀑	瀑布	瀑布群
瀑	瀑布	瀑布群
亨	亨利	亨特
腊	腊月	腊肉
腊	腊月	腊肉
眈	眈眈	
甸	甸子	
歆	歆羡	歆羨
咣	咣当	咣噹
跆	跆拳道	跆拳
惦	惦记	惦记着
讳	讳莫如深	讳疾忌医
迸	迸发	迸发出
锡	锡安	锡林
沛	沛县	
署	署名	署长
衔	衔接	衔尾
淇	淇澳	淇县
婵	婵娟	
秉	秉承	秉性
匠	匠人	匠师
羲	羲皇上人	
绮	绮罗	绮丽
恕	恕罪	恕我直言
纨	纨绔	纨绔子弟
嵌	嵌入	嵌进
嵌	嵌入	嵌进
糙	糙米	糙米饭
靡	靡靡之音	靡丽
弈	弈棋	弈具
藉	藉此	藉口
韧	韧性	韧带
蛟	蛟龙	蛟河
烽	烽火	烽火台
鲤	鲤鱼	鲤鱼打挺
灶	灶台	灶房
峥	峥嵘	峥嵘岁月
渍	渍水	渍染
筐	筐子	筐头子
橘	橘子	橘黄色
柿	柿子	柿子树
玖	玖艘	
匿	匿名	匿名信
茧	茧子	茧绸
璨	璨美	
莺	莺莺燕燕	莺燕
癞	癞蛤蟆	癞蛤蟆想吃天鹅肉
瑕	瑕疵	瑕不掩瑜
莞	莞尔一笑	莞尔
莞	莞尔一笑	莞尔
缉	缉毒	缉拿
缉	缉毒	缉拿
炖	炖肉	炖鸡
笃	笃定	笃笃
歧	歧视	歧义
厄	厄运	厄尔尼诺
膨	膨胀	膨胀起来
矜	矜持	矜贵
矜	矜持	矜贵
矜	矜持	矜贵
驼	驼背	驼子
幢	幢幢	
燎	燎原	燎原之势
幢	幢幢	
朕	朕兆	
绚	绚丽	绚烂
澎	澎湃	澎湖湾
侥	侥幸	侥幸心理
侥	侥幸	侥幸心理
呱	呱呱	呱呱叫
淤	淤血	淤泥
伶	伶俐	伶牙俐齿
挟	挟持	挟着
娄	娄子	娄底
趾	趾高气扬	趾高气昂
彰	彰显	彰扬
镯	镯子	
襟	襟怀	襟翼
吨	吨位	吨重
梢	梢头	梢子
薰	薰衣草	薰香
伽	伽马	伽蓝
伽	伽马	伽蓝
伽	伽马	伽蓝
蓓	蓓蕾	蓓尔
邋	邋遢	邋里邋遢
睦	睦邻	睦邻友好
橡	橡皮	橡胶
磋	磋商	磋磨
惟	惟一	惟妙惟肖
挎	挎包	挎着
墩	墩子	墩布
哩	哩哩啦啦	哩哩啰啰
羁	羁绊	羁押
缪	缪荃孙	缪云台
槐	槐树	槐花
噪	噪音	噪杂
旱	旱烟	旱魃
恺	恺撒	恺撒大帝
簇	簇拥	簇拥着
铸	铸造	铸就
昵	昵称	
斐	斐然	斐济
疆	疆域	疆土
聆	聆听	聆讯
璀	璀璨	璀璨夺目
窦	窦建德	窦娥冤
殆	殆尽	殆及
矢	矢口否认	矢量
掂	掂量	掂量掂量
咂	咂嘴	咂咂嘴
腼	腼腆	腼颜事敌
屡	屡屡	屡次
唏	唏嘘	唏噓
赎	赎罪	赎金
掷	掷地有声	掷骰子
沓	沓至	沓杂
沓	沓至	沓杂
旨	旨意	旨在
獠	獠牙	
哐	哐当	哐啷
券	券商	券门
券	券商	券门
驭	驭者	驭手
偎	偎依	偎着
荧	荧光	荧幕
峙	峙立	
峙	峙立	
沥	沥青	沥沥
嗝	嗝儿	
俨	俨然	俨如
踱	踱步	踱去
炕	炕头	炕沿
矣	矣哉	
缴	缴费	缴纳
缴	缴费	缴纳
傀	傀儡	傀儡政权
颂	颂歌	颂扬
洼	洼地	洼里
馋	馋猫	馋嘴
栈	栈道	栈桥
迦	迦南	迦太基
喏	喏喏连声	
喏	喏喏连声	
寅	寅时	寅虎
戟	戟指怒目	
曳	曳引机	曳光弹
靳	靳云鹏	靳羽西
窘	窘迫	窘境
禄	禄星	禄位
梗	梗着	梗死
殃	殃及池鱼	殃及
飒	飒飒	飒爽
蚕	蚕食	蚕豆
谍	谍报	谍报人员
匣	匣子	匣钵
蒜	蒜苗	蒜头
敦	敦实	敦厚
诫	诫命	诫律
辽	辽阔	辽宁
缀	缀补	缀连
蹊	蹊跷	蹊径
蹊	蹊跷	蹊径
靴	靴子	靴尖
霹	霹雳	霹雳舞
骸	骸骨	
磅	磅礴	磅秤
磅	磅礴	磅秤
蹿	蹿出	蹿到
鳄	鳄鱼	鳄鱼皮
蝼	蝼蚁	蝼蛄
嵩	嵩山	嵩山少林寺
醺	醺醺	醺醺然
鸢	鸢尾	鸢尾花
俭	俭朴	俭以养德
圳	圳沟	
臻	臻于完善	臻于极致
钝	钝器	钝响
弩	弩箭	弩弓
芹	芹菜	芹菜汤
洽	洽谈	洽谈会
灸	灸法	灸术
斋	斋饭	斋戒
钳	钳子	钳制
壤	壤土	壤塘
黠	黠戛斯	黠慧
嚏	嚏喷	
堤	堤坝	堤上
冈	冈山县	冈田
榴	榴莲	榴弹
倘	倘若	倘使
榆	榆木	榆树
倘	倘若	倘使
恙	恙虫	
瓢	瓢泼大雨	瓢泼
泻	泻药	泻火
羿	羿射九日	
蕉	蕉叶	蕉岭
骰	骰子	
呻	呻吟	呻吟声
乒	乒乓球	乒乒乓乓
鞘	鞘翅	鞘翅目
鞘	鞘翅	鞘翅目
曝	曝光	曝晒
曝	曝光	曝晒
蔷	蔷薇	蔷薇花
隧	隧道	隧道口
庇	庇护	庇佑
惆	惆怅	惆然
弑	弑父	弑君
淮	淮南	淮安
蘑	蘑菇	蘑菇云
厥	厥阴	厥功甚伟
坝	坝子	坝上
肴	肴馔	
褐	褐色	褐红色
跋	跋扈	跋涉
哔	哔哩啪啦	哔哔声
肮	肮脏	肮脏交易
菡	菡萏	菡子
猖	猖狂	猖獗
簸	簸箕	簸箩
卒	卒子	卒业
卒	卒子	卒业
蠕	蠕动	蠕虫
痘	痘痘	痘子
裔	裔胄	
迭	迭起	迭出
坨	坨子	
乓	乓乓	
忿	忿忿	忿忿不平
韬	韬光养晦	韬略
陛	陛下	
颁	颁发	颁布
缅	缅怀	缅甸
轶	轶事	轶闻
拷	拷问	拷贝
绫	绫罗绸缎	绫罗
琥	琥珀	琥珀色
仨	仨月	仨俩
嫦	嫦娥	嫦娥奔月
寇	寇仇	寇振海
渝	渝州	渝水
雍	雍容华贵	雍容
戎	戎装	戎马
绸	绸缎	绸布
癖	癖好	癖性
嗲	嗲声嗲气	嗲地
煽	煽情	煽动
冀	冀州	冀北
茸	茸毛	茸茸
瞌	瞌睡	瞌睡虫
荀	荀彧	荀子
虔	虔诚	虔诚地
苛	苛刻	苛责
禀	禀报	禀告
咄	咄咄逼人	咄咄
荤	荤菜	荤腥
楷	楷模	楷书
楷	楷模	楷书
拗	拗不过	拗口
拗	拗不过	拗口
枣	枣树	枣子
刨	刨根问底	刨出来
萦	萦绕	萦绕在
刨	刨根问底	刨出来
锥	锥子	锥心
倭	倭寇	倭奴
袅	袅袅	袅娜
皎	皎洁	皎白
耕	耕种	耕地
螃	螃蟹	螃蟹壳
岑	岑溪	岑寂
憎	憎恨	憎恶
缥	缥缈	缥渺
酝	酝酿	酝藉
珀	珀尔	珀斯
扉	扉页	扉画
糯	糯米	糯米饭
煦	煦和	煦煦
淬	淬炼	淬火
鳖	鳖甲	鳖肉
跷	跷课	跷跷板
睽	睽睽	睽违
鸳	鸳鸯	鸳鸯浴
叩	叩首	叩头
仕	仕途	仕女图
晾	晾晒	晾干
靶	靶子	靶场
窑	窑洞	窑子
溶	溶洞	溶解
坷	坷垃	
狩	狩猎	狩猎者
鬓	鬓角	鬓发
嬴	嬴政	
曙	曙光	曙色
猝	猝不及防	猝死
丙	丙级	丙辰
赘	赘肉	赘述
剖	剖析	剖开
吝	吝啬	吝惜
秽	秽物	秽语
辗	辗转	辗转反侧
玺	玺印	
蚩	蚩尤	蚩尤寨
芜	芜湖	芜杂
奚	奚落	奚啸伯
贬	贬低	贬值
芮	芮乃伟	芮城县
筛	筛选	筛子
讷	讷讷	讷河
赦	赦免	赦令
牟	牟利	牟取
剁	剁成	剁碎
褶	褶皱	褶子
谄	谄媚	谄笑
菌	菌类	菌子
姣	姣好	姣美
簌	簌簌	簌地
旬	旬阳	旬邑
驯	驯服	驯养
驹	驹子	
瞿	瞿秋白	瞿式耜
皂	皂荚	皂白
耷	耷拉	
牡	牡丹	牡丹花
撵	撵走	撵出去
诽	诽谤	诽谤罪
粟	粟子	粟米
眺	眺望	眺望塔
垒	垒砌	垒墙
寰	寰宇	寰球
锄	锄头	锄草
槛	槛车	槛墙
戛	戛然而止	戛然
槛	槛车	槛墙
咫	咫尺	咫尺天涯
紊	紊乱	紊乱如麻
褥	褥子	褥单
撮	撮合	撮箕
栅	栅栏	栅栏门
撮	撮合	撮箕
栅	栅栏	栅栏门
咨	咨询	咨询台
宪	宪法	宪宗
阑	阑珊	阑尾炎
斟	斟酌	斟满
芭	芭比娃娃	芭蕉
粤	粤语	粤省
撬	撬开	撬棍
佼	佼佼者	佼佼
辍	辍学	辍学生
龌	龌龊	龌龊事
踝	踝关节	踝骨
飕	飕飕	
淅	淅淅沥沥	淅沥沥
咀	咀嚼	咀咒
咀	咀嚼	咀咒
瞩	瞩目	瞩望
闸	闸门	闸口
荼	荼毒	荼毒生灵
杵	杵臼	
冶	冶金	冶炼
榕	榕树	榕城
泯	泯灭	泯没
滕	滕王阁	滕文公
裘	裘千尺	裘皮
彷	彷徨	彷佛
彷	彷徨	彷佛
锵	锵锵	
昼	昼夜	昼伏夜出
椎	椎骨	椎体
椎	椎骨	椎体
砌	砌成	砌墙
枢	枢纽	枢机
甥	甥舅	甥儿
慷	慷慨	慷慨激昂
雏	雏形	雏鹰
翱	翱翔	翱翔天空
亵	亵渎	亵玩
辖	辖区	辖下
蟑	蟑螂	蟑螂乐队
扈	扈从	扈三娘
闵	闵行区	闵采尔
懿	懿旨	懿德
涅	涅槃	涅盘
忒	忒楞楞	
鲸	鲸鱼	鲸吞
恪	恪守	恪尽职守
淀	淀粉	淀粉酶
凿	凿开	凿子
蛾	蛾子	蛾眉
栓	栓子	栓塞
贿	贿赂	贿款
勘	勘察	勘查
佯	佯装	佯攻
榨	榨菜	榨取
颐	颐指气使	颐养天年
浙	浙江	浙大
橱	橱窗	橱柜
冕	冕服	冕旒
瘟	瘟神	瘟疫
烘	烘烤	烘托
锯	锯齿	锯子
胯	胯下	胯部
峡	峡谷	峡口
痊	痊愈	痊癒
卯	卯足了劲	卯足
丞	丞相	
疵	疵点	疵议
嗑	嗑瓜子	
捺	捺印	
郡	郡主	郡王
俘	俘虏	俘获
鸾	鸾鸟	鸾凤
疮	疮痍	疮疤
佘	佘太君	佘一元
噶	噶尔丹	噶尔
萤	萤火虫	萤火
峨	峨眉	峨眉山
栾	栾城	栾南
苔	苔藓	苔丝
舆	舆论	舆论压力
巩	巩固	巩膜
酌	酌情	酌酒
溯	溯源	溯流
硝	硝烟	硝烟弥漫
讹	讹诈	讹人
谴	谴责	
簧	簧片	簧乐器
羔	羔羊	羔子
孜	孜孜不倦	孜然
垢	垢污	垢面蓬头
苇	苇子	苇河
螳	螳螂	螳螂捕蝉
剿	剿灭	剿匪
栖	栖息	栖身
剿	剿灭	剿匪
醇	醇厚	醇香
栖	栖息	栖身
剃	剃着	剃须刀
饲	饲料	饲养
筠	筠连	筠连县
筠	筠连	筠连县
屹	屹立	屹然
芥	芥蒂	芥末
芥	芥蒂	芥末
矗	矗立	矗起
龇	龇牙咧嘴	龇牙
槟	槟榔	槟城
蜕	蜕变	蜕皮
笋	笋丝	笋干
砚	砚台	砚石
隋	隋朝	隋菲菲
舵	舵主	舵手
酣	酣睡	酣畅淋漓
稠	稠密	稠乎乎
沪	沪市	沪江
啄	啄米	啄食
鹦	鹦鹉	鹦鹉螺
媲	媲美	
奠	奠定	奠基
纺	纺织	纺织厂
凋	凋零	凋谢
莘	莘莘学子	莘县
篆	篆体	篆字
甭	甭管	甭想
扼	扼杀	扼住
嘤	嘤其鸣矣	
弛	弛缓	弛懈
孰	孰不可忍	孰轻孰重
遐	遐想	遐思
炊	炊烟	炊烟袅袅
涎	涎水	涎着脸
遏	遏制	遏止
蜈	蜈蚣	蜈蚣洞
匾	匾额	匾牌
辘	辘辘	辘轳
锣	锣鼓	锣鼓喧天
帚	帚柄	帚子
惘	惘然	惘然若失
抉	抉择	抉擇
惰	惰性	惰性气体
箍	箍紧	箍桶
叱	叱咤风云	叱咤
峭	峭壁	峭拔
屯	屯子	屯里
屯	屯子	屯里
昙	昙花一现	昙花
貂	貂蝉	貂皮
掖	掖县	掖进
蔫	蔫蔫	蔫头耷脑
庚	庚辰	庚午
踮	踮起	踮着
祠	祠堂	祠庙
肇	肇事	肇事者
邂	邂逅	邂逅相遇
饕	饕餮	饕餮之徒
籽	籽儿	籽种
娓	娓娓道来	娓娓
亘	亘古	亘古不灭
涣	涣散	涣然
忡	忡忡	
臊	臊子	臊气
簿	簿子	簿册
珞	珞巴	珞珈
伫	伫立	伫足
芋	芋头	芋艿
穗	穗子	穗城
亓	亓诗教	
俐	俐落	
韶	韶华	韶关
窖	窖藏	窖子
踌	踌躇	踌躇满志
稼	稼穑	稼穑艰难
趔	趔趄	趔趔趄趄
瘤	瘤子	瘤胃
蜗	蜗牛	蜗居
咿	咿呀	咿咿呀呀
枷	枷锁	枷鎖
吠	吠叫	吠声
冼	冼星海	
沼	沼泽	沼泽地
碳	碳素	碳酸
翌	翌日	翌年
怦	怦然心动	怦怦
渎	渎职	渎职罪
匡	匡扶	匡扶汉
藐	藐视	藐视一切
汀	汀娜	汀江
赃	赃物	赃款
衙	衙门	衙役
幡	幡然醒悟	幡然悔悟
祀	祀神	祀祖
喀	喀嚓	喀秋莎
佰	佰草集	
拣	拣起	拣到
阙	阙如	阙至尊
弋	弋阳	弋获
於	於是	於此
於	於是	於此
恃	恃强凌弱	恃才傲物
熔	熔炉	熔岩
岐	岐山	岐黄
盅	盅子	
汶	汶川	汶山
羹	羹匙	羹汤
饵	饵料	饵食
拄	拄着	拄杖
募	募捐	募集
倏	倏地	倏然
熹	熹微	熹平
襄	襄阳	襄王
迂	迂腐	迂回
嫡	嫡系	嫡传
坂	坂崎由莉	坂本龙
攸	攸关	攸然
蜒	蜒蚰	
谩	谩骂	谩骂者
盎	盎然	盎司
蜿	蜿蜒	
渲	渲染	渲泄
蔺	蔺相如	蔺草
谬	谬赞	谬论
帷	帷幕	帷帐
捎	捎带	捎来
骅	骅骝	
榻	榻榻米	榻板
诬	诬陷	诬赖
啜	啜泣	啜泣声
垄	垄断	垄沟
辐	辐射	辐射强度
胚	胚子	胚胎
篱	篱笆	篱笆墙
炳	炳灵	炳发
煲	煲汤	煲仔饭
冢	冢中枯骨	冢木已拱
毋	毋庸置疑	毋庸
潺	潺潺	潺潺流水
泌	泌出	泌尿系统
泌	泌出	泌尿系统
畴	畴昔	
沅	沅水	沅江
庐	庐山	庐山真面目
粼	粼粼	粼粼碧波
忖	忖道	忖度
篝	篝火	篝火狐鸣
抒	抒发	抒情
轲	轲比能	
虏	虏获	虏掠
蛰	蛰伏	蛰虫
蜻	蜻蜓	蜻蜓点水
俟	俟河之清	俟机
篓	篓子	篓筐
俟	俟河之清	俟机
涮	涮羊肉	涮锅
忏	忏悔	忏悔录
礁	礁石	礁岩
婀	婀娜	婀娜多姿
铿	铿锵有力	铿锵
粽	粽子	粽粑
璧	璧山	璧玉
桓	桓台	桓玄
瀛	瀛洲	瀛州
鼾	鼾声	鼾声如雷
苞	苞米	苞谷
滤	滤过	滤清
蹂	蹂躏	
蜥	蜥蜴	蜥蜴人
煊	煊赫	
栀	栀子花	栀子
浒	浒墅关	浒山
咎	咎由自取	咎有应得
浒	浒墅关	浒山
捻	捻起	捻灭
瞻	瞻仰	瞻前顾后
雌	雌性	雌雄
瓮	瓮声瓮气	瓮中捉鳖
蹒	蹒跚	蹒跚而行
嫖	嫖客	嫖妓
阀	阀门	阀门厂
潼	潼关	潼南
娑	娑婆	娑罗树
搪	搪塞	搪瓷
鱿	鱿鱼	鱿鱼丝
秧	秧苗	秧子
鲲	鲲鹏	鲲鹏展翅
柬	柬埔寨	柬帖
璞	璞玉	璞鼎查
鸥	鸥鸟	鸥鹭忘机
迢	迢迢	迢遥
磐	磐石	磐安
诠	诠释	诠释者
毓	毓秀	毓璜顶
浠	浠水	浠水县
夔	夔门	夔龙
栎	栎树	栎阳
飓	飓风	
栎	栎树	栎阳
湮	湮灭	湮没
逾	逾越	逾期
濒	濒临	濒死
佝	佝偻	佝偻病
皑	皑皑	
阐	阐述	阐释
烹	烹饪	烹制
瞑	瞑目	瞑想
卤	卤肉	卤蛋
粱	粱山	粱肉
痰	痰盂	痰饮
坍	坍塌	坍缩
惴	惴惴不安	惴惴
拴	拴着	拴住
胭	胭脂	胭脂粉
犷	犷悍	
噙	噙齿戴发	
纬	纬度	纬线
臃	臃肿	臃腫
涧	涧水	涧溪
浣	浣熊	浣纱
掣	掣肘	掣电
诲	诲人不倦	诲淫诲盗
藕	藕断丝连	藕粉
歼	歼灭	歼敌
怏	怏怏	怏怏不乐
缤	缤纷	缤纷多彩
椰	椰子	椰子树
遛	遛弯	遛狗
腺	腺体	腺癌
鹊	鹊桥	鹊起
宓	宓汝成	
怵	怵目惊心	怵然
邸	邸宅	邸阁
腋	腋下	腋窝
颔	颔首	颔下
泱	泱泱	泱泱大国
纶	纶巾	纶巾羽扇
纶	纶巾	纶巾羽扇
馍	馍馍	
窈	窈窕	窈窕淑女
吏	吏部	吏治
揶	揶揄	
莜	莜麦	
匍	匍匐	匍匐前进
蟾	蟾蜍	蟾宫
蟠	蟠桃	蟠桃会
譬	譬如	譬如说
掸	掸子	掸帚
掸	掸子	掸帚
钵	钵盂	钵头
舀	舀水	舀出
垣	垣曲	垣曲县
岱	岱庙	岱山
孬	孬种	
卞	卞之琳	卞夫人
夙	夙愿	夙夜
壹	壹号	壹一
匐	匐伏	
玷	玷污	玷辱
樟	樟树	樟树下
馄	馄饨	馄饨面
羚	羚羊	羚羊挂角
殡	殡仪馆	殡葬
犒	犒劳	犒赏
俑	俑坑	
濡	濡湿	濡染
噤	噤声	噤若寒蝉
庶	庶民	庶子
瞠	瞠目结舌	瞠目
藻	藻类	藻井
鸠	鸠摩智	鸠占鹊巢
缆	缆车	缆绳
咩	咩咩叫	
汕	汕头	汕尾
豚	豚鼠	豚草
颦	颦眉	
搔	搔首弄姿	搔头
柚	柚子	柚子茶
汩	汩汩	
盹	盹儿	
衲	衲衣	衲子
嶙	嶙峋	
耙	耙子	耙地
伎	伎俩	伎倆
耙	耙子	耙地
镀	镀金	镀上
揖	揖拜	揖谢
茨	茨威格	茨冈
秤	秤砣	秤杆
鹭	鹭岛	鹭鸟
邬	邬倩倩	邬桥真
婊	婊子	
伢	伢子	
桨	桨叶	桨声
嗬	嗬哟	
妓	妓女	妓院
瘴	瘴气	瘴疠
鹫	鹫峰	鹫山
缰	缰绳	
眦	眦裂	眦裂发指
隍	隍城	
臼	臼齿	臼杵
潦	潦草	潦倒
魑	魑魅魍魉	魑魅
蹩	蹩脚	蹩脚货
绢	绢丝	绢画
阡	阡陌	阡表
浔	浔江	
犟	犟嘴	犟脾气
臆	臆想	臆测
豺	豺狼	豺狼虎豹
恻	恻隐之心	恻隐
嗣	嗣后	嗣位
绉	绉纹	绉纱
幌	幌子	幌动
蚯	蚯蚓	
沏	沏茶	
蹉	蹉跎	蹉跎岁月
拈	拈花	拈花惹草
膺	膺品	膺任
袒	袒护	袒露
踵	踵事增华	踵至
涸	涸泽而渔	涸辙之鲋
蛐	蛐蛐	蛐蛐儿
潢	潢川	潢川县
殒	殒命	殒灭
桔	桔子	桔梗
茎	茎杆	茎干
孺	孺子可教	孺子不可
悼	悼念	悼词
缎	缎带	缎子
谛	谛听	谛视
菠	菠萝	菠菜
嬷	嬷嬷	
睨	睨视	
蛆	蛆虫	
壕	壕沟	壕堑
汲	汲取	汲水
堇	堇色	堇菜
偃	偃月	偃旗息鼓
腌	腌制	腌菜
腌	腌制	腌菜
颚	颚骨	
吮	吮吸	吮痈舐痔
沭	沭阳	沭河
黍	黍子	黍米
旖	旖旎	旖旎风光
酵	酵母菌	酵母
蕙	蕙兰	蕙质兰心
燮	燮理	燮理阴阳
炬	炬火	
舜	舜天	舜帝
褒	褒奖	褒义词
愠	愠怒	愠色
渤	渤海	渤海湾
阉	阉割	阉人
倡	倡导	倡议
噘	噘嘴	噘嘴儿
僚	僚机	僚属
倜	倜傥	倜傥不群
椭	椭圆形	椭圆
潞	潞河	潞安
硫	硫酸	硫磺
荔	荔枝	荔枝树
膳	膳食	膳房
帛	帛书	帛画
睚	睚眦必报	睚眦
脐	脐带	脐橙
圭	圭亚那	圭臬
酉	酉时	酉阳
镐	镐头	镐京
镐	镐头	镐京
钒	钒铁	
姊	姊妹	姊姊
鞍	鞍前马后	鞍山
缔	缔造	缔结
觊	觊觎	
砺	砺石	
孵	孵化	孵出
濑	濑户内海	濑户
锃	锃亮	锃光瓦亮
瑙	瑙鲁	瑙曼
梆	梆梆	梆子
泫	泫然泪下	泫然欲泪
韭	韭菜	韭黄
泷	泷泽秀明	
泷	泷泽秀明	
呶	呶呶不休	
涤	涤荡	涤卡
磷	磷火	磷光
蚱	蚱蜢	蚱蝉
隽	隽永	隽拔
鳝	鳝鱼	
萃	萃取	萃取液
婢	婢女	婢子
幂	幂函数	幂指数
坯	坯子	坯料
唆	唆使	
掳	掳走	掳掠
匮	匮乏	匮缺
杳	杳无音信	杳无音讯
褴	褴褛	褴褛不堪
臧	臧克家	臧否
岌	岌岌可危	岌岌
犁	犁地	犁田
撰	撰写	撰稿人
甬	甬道	甬路
稷	稷下	稷山
骋	骋目	骋怀
憩	憩息	
钛	钛合金	钛酸
埔	埔里	埔里镇
埔	埔里	埔里镇
郗	郗恩庭	
嘁	嘁嘁喳喳	嘁嘁嚓嚓
掇	掇菁撷华	
烩	烩面	烩饭
鲫	鲫鱼	鲫鱼汤
橄	橄榄枝	橄榄
馊	馊主意	馊味
蒯	蒯异度	蒯侍郎
嘹	嘹亮	
桠	桠枫	桠杈
鳌	鳌拜	鳌头
骥	骥骜	
缜	缜密	缜密性
揩	揩油	揩去
邙	邙山	
垛	垛子	垛口
脓	脓包	脓水
夯	夯实	夯货
钙	钙片	钙化
夯	夯实	夯货
琵	琵琶	琵琶骨
谤	谤议	
焊	焊接	焊枪
釜	釜山	釜底抽薪
孑	孑然一身	孑然
枸	枸杞	枸杞子
枸	枸杞	枸杞子
闽	闽南	闽江
蘸	蘸上	蘸湿
瑚	瑚琏之器	
荟	荟萃	荟萃一堂
碴	碴儿	
鄂	鄂州	鄂伦春
遨	遨游	遨游太空
陕	陕西	陕北
亥	亥时	亥猪
殉	殉情	殉职
胥	胥吏	胥各庄
硅	硅胶	硅谷
罂	罂粟	罂粟花
谙	谙熟	谙晓
氤	氤氲	氤氳
诋	诋毁	
淞	淞沪	
涓	涓涓	涓涓细流
纾	纾解	纾忧
纣	纣王	
摒	摒弃	摒除
隘	隘口	隘路
鸷	鸷鸟	鸷鹰
巽	巽他群岛	巽他
逯	逯钦立	
捍	捍卫	捍卫者
哺	哺育	哺乳动物
荏	荏苒	荏弱
簪	簪子	簪缨
旮	旮旯	旮旯儿
佚	佚名	佚事
祛	祛除	祛病
篡	篡改	篡位
拮	拮据	拮抗剂
叁	叁天	
苯	苯胺	苯教
恽	恽代英	恽寿平
绛	绛红色	绛色
铝	铝合金	铝锅
毡	毡帽	毡子
茁	茁壮成长	茁壮
艮	艮岳	
徙	徙步	徙居
掬	掬水	掬诚
侨	侨民	侨胞
谕	谕旨	谕令
呓	呓语	
畸	畸形	畸变
姹	姹紫嫣红	姹紫焉红
蓁	蓁蓁	
酩	酩酊大醉	酩酊
蜚	蜚语	蜚声
赝	赝品	赝鼎
酋	酋长	酋长国
谆	谆谆教导	谆谆教诲
砾	砾石	砾岩
笆	笆篱	笆斗
箩	箩筐	箩卜
迥	迥异	迥然不同
骡	骡子	骡马
麾	麾下	麾军
镂	镂空	镂刻
洱	洱海	洱源县
宕	宕机	宕昌县
嗫	嗫嚅	嗫嗫嚅嚅
竣	竣工	竣事
槌	槌子	槌棒
黔	黔驴技穷	黔县
膘	膘肥体壮	膘肥体胖
蹶	蹶子	
纰	纰漏	纰缪
焖	焖饭	焖牛肉
狒	狒狒	
嚅	嚅嚅	
剽	剽窃	剽悍
邯	邯郸	邯郸学步
筏	筏子	筏头
嗳	嗳呀	嗳气
埂	埂子	
堑	堑壕	堑山堙谷
荨	荨麻疹	荨麻
鎏	鎏金	
聒	聒噪	聒耳
茴	茴香	茴香豆
栉	栉风沐雨	栉比
虱	虱子	虱多不痒
蛀	蛀虫	蛀牙
迄	迄今为止	迄今
偕	偕老	偕同
虬	虬龙	虬髯
泗	泗水	泗州
忤	忤逆	忤逆不孝
雎	雎鸠	
阖	阖家欢乐	阖家幸福
糜	糜烂	糜烂不堪
钗	钗头凤	钗横鬓乱
逄	逄先知	
贰	贰仟	贰心
赳	赳赳	赳赳武夫
剜	剜肉补疮	剜除
麋	麋鹿	麋羚
霁	霁月	霁月光风
睥	睥睨	睥睨一切
嫔	嫔妃	嫔从
睢	睢宁	睢县
缨	缨子	缨络
渭	渭河	渭水
忻	忻州	忻口
谀	谀词	谀辞
孱	孱弱	孱头
杞	杞人忧天	杞县
孱	孱弱	孱头
潸	潸然泪下	潸然
侏	侏儒	侏罗纪
湍	湍急	湍流
砣	砣子	
呤	呤呤	
沂	沂蒙	沂河
榔	榔头	榔榆
糠	糠麸	糠皮
噱	噱头	
噱	噱头	
犄	犄角	犄角之势
挛	挛生	挛缩
澹	澹台	澹台小姐
氢	氢气	氢气球
襁	襁褓	襁褓之中
澹	澹台	澹台小姐
擀	擀面杖	擀毡
轱	轱辘	轱轳
竺	竺可桢	竺法护
皖	皖南	皖北
莠	莠民	
碉	碉堡	碉楼
痉	痉挛	痉挛性
贲	贲门	贲临
赁	赁租	
潋	潋滟	
涔	涔涔	
荻	荻村伊智朗	
颌	颌骨	颌面
鸵	鸵鸟	鸵鸟蛋
鼬	鼬鼠	鼬獾
峪	峪口	
樵	樵夫	樵采
颌	颌骨	颌面
踊	踊跃	踊跃报名
濮	濮阳	濮存昕
陇	陇西	陇南
蚌	蚌壳	蚌埠
噻	噻吩	噻嗪
驮	驮背	驮负
泾	泾渭分明	泾源
驮	驮背	驮负
氮	氮气	氮肥厂
瘠	瘠薄	瘠瘦
儆	儆戒	
彗	彗星	彗尾
札	札记	札幌
釉	釉里红	釉色
蔻	蔻丹	
遑	遑论	遑遑不可
讼	讼师	讼词
殄	殄灭	
炀	炀帝	
娉	娉婷	娉娉婷婷
羌	羌族	羌塘
蝈	蝈蝈	蝈蝈儿
诏	诏书	诏令
咝	咝咝	咝咝声
黢	黢黑	
刈	刈草	刈稻
垦	垦荒地	垦地
庵	庵堂	庵主
囤	囤积	囤货
囤	囤积	囤货
舷	舷窗	舷梯
醍	醍醐灌顶	醍醐
蝗	蝗虫	蝗灾
桎	桎梏	
铂	铂金	铂金卡
娼	娼妓	娼妇
颉	颉颃	
瘀	瘀伤	瘀血
颉	颉颃	
恁	恁地	恁般
饽	饽饽	
诨	诨名	诨号
孪	孪生	孪生兄弟
锭	锭子	
赊	赊账	赊欠
缄	缄默	缄口不言
箬	箬笠	箬帽
尕	尕斯库勒	尕玛
珲	珲春	珲春市
铤	铤而走险	
沽	沽名钓誉	沽酒
龅	龅牙	
扪	扪心自问	扪心
鲛	鲛绡	
茯	茯苓	茯神
肱	肱骨	肱股
冗	冗长	冗杂
诃	诃德	诃子
濯	濯濯	濯足
倨	倨傲	倨傲不恭
怆	怆然泪下	怆然涕下
恣	恣意	恣肆
赧	赧然	赧颜
魍	魍魉	魍魎
钠	钠灯	钠离子
悖	悖论	悖逆
沱	沱江	沱沱河
肛	肛门	肛裂
桧	桧木	桧柏
桧	桧木	桧柏
茱	茱莉亚	茱萸
跛	跛子	跛脚
蝌	蝌蚪	蝌蚪文
淆	淆乱	淆惑
锌	锌皮	锌矿
轧	轧死	轧钢厂
轧	轧死	轧钢厂
轧	轧死	轧钢厂
驷	驷马难追	驷马
隗	隗瀛涛	
酗	酗酒	酗酒滋事
齑	齑粉	
羸	羸弱	羸疾
刽	刽子手	
俎	俎上肉	俎上之肉
隗	隗瀛涛	
晁	晁错	晁补之
宦	宦官	宦之家
帧	帧定位	帧频
摹	摹仿	摹本
蛹	蛹期	
箕	箕门	箕帚
颧	颧骨	
萘	萘酚	
崆	崆峒	崆峒山
徜	徜徉	徜徉于
囫	囫囵	囫囵吞枣
獐	獐头鼠目	獐子
罔	罔顾	罔替
壬	壬戌	壬申
巳	巳时	巳蛇
驿	驿站	驿馆
痨	痨病	
蒿	蒿草	蒿子
蛭	蛭石	
磬	磬竹难书	
椿	椿树	椿萱
酊	酊剂	
铄	铄石流金	铄金
睑	睑缘炎	睑下垂
鹑	鹑衣百结	鹑衣
乜	乜斜	乜嘢
乜	乜斜	乜嘢
跻	跻身	跻身于
锲	锲而不舍	
蕤	蕤宾	蕤仁
抨	抨击	抨弹
蜃	蜃楼	蜃景
孚	孚日	孚众望
镌	镌刻	镌印
笺	笺纸	笺注
搽	搽着	搽药
怄	怄气	
葶	葶苈子	
毗	毗邻	毗连
豌	豌豆	豌豆荚
俾	俾斯麦	俾昼作夜
泵	泵房	泵车
鹌	鹌鹑	鹌鹑蛋
撺	撺掇	撺弄
滇	滇南	滇西
圩	圩镇	圩堤
藩	藩王	藩篱
圩	圩镇	圩堤
恹	恹恹	
鬣	鬣狗	鬣鬃
砧	砧板	砧木
郴	郴县	郴州
滂	滂沱	滂沱大雨
鳗	鳗鱼	鳗鲡
楔	楔子	楔形
樯	樯橹	樯倾楫摧
荃	荃湾	荃灣
湄	湄公河	湄南河
蝮	蝮蛇	蝮蛇螫手
匝	匝道	匝地
榛	榛子	榛蘑
忸	忸怩	忸怩不安
旌	旌旗	旌阳
诙	诙谐	诙谐地
灞	灞河	灞桥
锚	锚链	锚地
挞	挞伐	
馥	馥郁	
鄢	鄢烈山	鄢陵
貔	貔貅	貔虎
迩	迩来	
胫	胫骨	
蠡	蠡园	蠡县
塾	塾师	
哂	哂笑	哂然
喙	喙长三尺	
邈	邈远	邈视
薏	薏米	薏苡
胛	胛骨	
碱	碱性	碱面
敕	敕令	敕封
邝	邝曰广	
羯	羯鼓	羯羊
伥	伥鬼	
霭	霭霭	
浚	浚县	
腱	腱子	腱鞘炎
浚	浚县	
螯	螯合物	螯合剂
戍	戍边	戍守
苌	苌弘化碧	
氨	氨基酸	氨气
皴	皴裂	皴法
裱	裱糊	裱画
矍	矍铄	
袈	袈裟	
獾	獾油	獾猪
枳	枳实	枳壳
鹄	鹄立	鹄形鸠面
鹄	鹄立	鹄形鸠面
镣	镣铐	
赡	赡养	赡养费
癸	癸丑	癸巳
雹	雹子	雹灾
耘	耘田	耘锄
叵	叵测	叵耐
酪	酪浆	酪氨酸
缮	缮写	缮修
秆	秆子	
蔗	蔗糖	蔗田
綦	綦江	綦母怀
蛔	蛔虫	蛔厥
脍	脍炙人口	脍炙
藓	藓苔	藓类
仄	仄仄	仄声
鸩	鸩毒	鸩酒
溥	溥仪	溥仪之
闰	闰年	闰月
桁	桁架	桁梁
镁	镁光灯	镁光
蕨	蕨菜	蕨类植物
痔	痔疮	痔漏
戌	戌时	戌狗
骊	骊山	骊歌
赣	赣州	赣南
敝	敝帚自珍	敝履
猕	猕猴	猕猴桃
恸	恸哭	
蝰	蝰蛇	
砝	砝码	
泸	泸州	泸沽湖
莳	莳萝	莳秧
蚤	蚤休	
樽	樽俎	樽前月下
耒	耒耜	耒阳
觥	觥筹交错	觥筹
膻	膻中	膻味
娩	娩出	
鼋	鼋头渚	鼋鱼
胴	胴体	
蹴	蹴鞠	
谪	谪仙	谪居
阪	阪神	阪田
谏	谏言	谏议
徇	徇私	徇私枉法
骐	骐骥	骐骥过隙
膈	膈膜	膈关
弭	弭兵之会	
匈	匈奴	匈牙利
笤	笤帚	
堰	堰塞湖	堰口
郸	郸城	郸城县
煅	煅烧	
蜇	蜇伤	
鬃	鬃毛	鬃刷
饷	饷银	饷客
遒	遒劲	遒健
舐	舐犊情深	舐食
槁	槁木	槁木死灰
舛	舛错	舛误
诓	诓骗	
纫	纫针	
胱	胱氨酸	胱胺酸
镊	镊子	
荜	荜澄茄	荜路蓝缕
诟	诟病	诟骂
沣	沣河	
罄	罄竹难书	罄尽
糅	糅合	糅杂
銮	銮驾	銮舆
歙	歙砚	歙县
歙	歙砚	歙县
邕	邕城	邕江
秸	秸秆	秸杆
缱	缱绻	
蟋	蟋蟀	蟋蟀草
嗟	嗟来之食	嗟叹
贮	贮存	贮藏
鹞	鹞子	鹞子翻身
髯	髯口	
刎	刎颈之交	
柑	柑橘	柑子
晤	晤面	晤对
烯	烯酮	烯丙基
筵	筵席	筵宴
熨	熨斗	熨帖
涝	涝灾	涝池
逡	逡巡	逡巡不前
雉	雉鸡	雉尾
珐	珐琅	珐琅质
贻	贻笑大方	贻误
钎	钎子	钎头
皈	皈依	
瘙	瘙痒	瘙痒症
诳	诳语	诳骗
猞	猞猁	
湟	湟中县	湟鱼
汾	汾酒	汾河
痢	痢疾	痢特灵
阆	阆苑	阆中
矬	矬子	
疹	疹子	疹块
翕	翕动	翕张
谲	谲而不正	
姘	姘头	姘居
镭	镭射	镭射光
牯	牯岭	牯牛
蟊	蟊贼	
侗	侗族	侗寨
杷	杷子	
侗	侗族	侗寨
舶	舶来品	舶来货
誊	誊写	誊抄
铡	铡刀	铡草
幔	幔帐	幔子
谚	谚语	
盂	盂兰盆会	盂县
碘	碘酒	碘钨灯
鹧	鹧鸪天	鹧鸪
唢	唢呐	唢呐声
戊	戊辰	戊戌变法
亟	亟需	亟待
汴	汴京	汴梁
汛	汛期	汛情
爻	爻辞	爻象
阄	阄割	
亟	亟需	亟待
颀	颀长	颀然
岿	岿然不动	岿然
掮	掮客	
鸪	鸪鸪	
酮	酮体	酮类
饯	饯行	饯别
翦	翦伯赞	
氯	氯化钠	氯化氢
胺	胺类	胺基酸
绥	绥靖	绥远
鳕	鳕鱼	
廿	廿四	廿年
埠	埠头	
趿	趿拉	趿着
厩	厩肥	
嵇	嵇中散	嵇中散集
莅	莅临	莅临指导
淙	淙淙	淙淙流水
砥	砥柱	砥砺
毽	毽子	
谗	谗言	谗猫
枇	枇杷	枇杷树
瓤	瓤子	
淄	淄博	淄川
迤	迤逦	
刍	刍狗	刍议
荞	荞麦	荞麦皮
瘌	瘌痢	瘌痢头
衮	衮州	衮衮
霰	霰弹枪	霰弹
铀	铀矿	
鲈	鲈鱼	
苜	苜蓿	苜蓿草
狍	狍子	
酶	酶系统	酶类
铆	铆钉	铆劲
唁	唁电	唁函
庖	庖厨	庖丁解牛
鲑	鲑鱼	
佤	佤族	
悱	悱恻	悱恻缠绵
诘	诘问	诘难
茕	茕茕孑立	
鲢	鲢鱼	
纂	纂修	纂辑
璎	璎珞	
攫	攫取	攫住
暨	暨大	暨南大学
遽	遽然	遽尔
蒽	蒽醌	蒽环类
铧	铧犁	
盥	盥洗室	盥洗
喟	喟叹	喟然
萼	萼片	
阜	阜阳	阜城
汨	汨罗	汨罗江
苕	苕帚	苕子
耆	耆那教	耆宿
崂	崂山	崂山区
苕	苕帚	苕子
鏖	鏖战	鏖兵
莆	莆田	莆田县
茏	茏葱	
靛	靛蓝色	靛蓝
掴	掴耳光	
驸	驸马	驸马爷
踟	踟蹰	踟蹰不前
芡	芡粉	芡实
锒	锒铛入狱	锒铛
罹	罹难	罹患
傣	傣族	傣家
皋	皋兰	皋兰县
猢	猢狲	
涑	涑水	
蠹	蠹虫	蠹鱼
勐	勐海县	勐腊
癣	癣疥	癣疥之疾
喑	喑哑	
豇	豇豆	
雒	雒于仁	
郦	郦道元	郦食其
焙	焙烧	焙茶
哓	哓哓	哓哓不休
洮	洮河	洮砚
豢	豢养	
觐	觐见	觐谒
芍	芍药	芍药花
媾	媾和	媾合
桅	桅杆	桅灯
楦	楦子	楦头
郢	郢州	郢书燕说
蓟	蓟州	蓟城
麝	麝香	麝鼠
箴	箴言	箴规
燧	燧石	燧人氏
颍	颍川	颍河
楹	楹联	
楸	楸子	楸树
葳	葳蕤	
箔	箔条	箔片
煸	煸炒	煸动
撷	撷取	撷拾
俸	俸禄	俸给
彝	彝族	彝人
蓼	蓼花	蓼藍
糍	糍粑	
鞑	鞑子	鞑虏
苁	苁蓉	
辊	辊子	辊轴
孢	孢子	孢粉
蕃	蕃茄	蕃薯
瓯	瓯越	瓯海
铩	铩羽而归	铩羽
汞	汞液	汞合金
貉	貉子	貉绒
铢	铢两	铢积寸累
稗	稗子	稗官野史
麸	麸皮	麸子
黟	黟县	
踽	踽踽独行	踽踽
闾	闾里	闾巷
蛎	蛎黄	
闩	闩门闭户	
潍	潍坊	潍坊市
佃	佃户	佃农
佃	佃户	佃农
闳	闳大不经	
擘	擘肌分理	擘画
蜉	蜉蝣	
棣	棣棠	
鲠	鲠直	
祢	祢衡	
氙	氙气	氙气灯
玳	玳瑁	玳玳花
镔	镔铁	
罅	罅隙	罅口
蚝	蚝油	
徵	徵兆	徵求
捭	捭阖	
倥	倥偬	
邰	邰正宵	邰丽华
偈	偈语	
荚	荚果	荚膜
渥	渥太华	渥丹
龈	龈交	龈齿弹舌
耄	耄耋	耄耋之年
跗	跗骨	跗蹠
饴	饴糖	
龈	龈交	龈齿弹舌
犍	犍为	犍为县
笞	笞击	笞杖
犍	犍为	犍为县
篙	篙子	篙头
熵	熵增加	
嗥	嗥叫	
寤	寤寐	寤寐求之
裨	裨益	裨将
牦	牦牛	牦牛肉
庾	庾澄庆	庾信
裨	裨益	裨将
砒	砒霜	砒石
衢	衢州	衢县
铬	铬铁	铬钢
涿	涿鹿	涿县
钾	钾盐	钾钠
俚	俚语	俚言
桉	桉树	桉树林
鳜	鳜鱼	
瓠	瓠子	
钨	钨丝灯	钨丝
麂	麂子	麂皮
讴	讴歌	讴吟
粲	粲然一笑	粲然
苫	苫布	苫盖
甑	甑子	
洄	洄游	
醛	醛酸	醛类
藜	藜芦	
玎	玎玎玲玲	
恫	恫吓	恫瘝
掼	掼纱帽	
柘	柘城	柘城县
鳃	鳃裂	鳃裂囊肿
睾	睾丸	睾酮
鲟	鲟鱼	
谒	谒见	谒拜
兖	兖州	兖州煤业
漕	漕运	漕粮
鹘	鹘入鸦群	
鹘	鹘入鸦群	
镍	镍币	镍都
蓑	蓑衣	蓑笠
卅	卅年	卅三
莨	莨菪	莨绸
腓	腓特烈	腓肠肌
垭	垭口	
鸨	鸨母	鸨婆
痱	痱子	痱子粉
犰	犰狳	
囹	囹圄	
涞	涞源	涞水
岫	岫岩	岫云
忝	忝不知耻	
凫	凫水	凫趋雀跃
郾	郾城	
鹬	鹬蚌相争	鹬蚌相持
谶	谶语	谶纬
氰	氰化	氰化钾
缛	缛节	
怛	怛然失色	
钕	钕铁硼	
荠	荠菜	荠荠菜
荠	荠菜	荠荠菜
浜	浜松	
殁	殁世不忘	
谯	谯楼	谯城区
馏	馏程	馏出物
腭	腭裂	
鳏	鳏夫	鳏寡孤独
侉	侉子	
绦	绦子	绦虫
胰	胰岛素	胰腺癌
钜	钜子	钜额
妊	妊娠	妊娠期
锉	锉刀	锉子
磴	磴道	磴口县
墒	墒情	
艄	艄公	
镗	镗孔	镗床
鼹	鼹鼠	
皲	皲裂	
辔	辔头	
蹼	蹼趾	
缌	缌麻服	
鼯	鼯鼠	
狻	狻猊	
佞	佞臣	佞笑
毂	毂辘	毂击肩摩
窠	窠臼	窠巢
吡	吡啶	吡哆醇
亳	亳州	亳县
荥	荥阳	荥经
癔	癔症	癔病
圜	圜丘	
荥	荥阳	荥经
碣	碣石	
圜	圜丘	
沆	沆瀣一气	沆瀣
妯	妯娌	
钿	钿合金钗	
菟	菟丝子	
肄	肄业	肄业生
澶	澶渊	
菖	菖蒲	
钿	钿合金钗	
泔	泔水	泔水桶
砷	砷中毒	砷化物
赈	赈灾	赈济
颛	颛顼	颛臾
痦	痦子	
狴	狴犴	
椽	椽子	
趵	趵突泉	趵突
莒	莒城	莒南
鄱	鄱阳湖	鄱阳
歃	歃血为盟	歃血
隳	隳肝沥胆	
斡	斡旋	斡旋到底
婺	婺源	婺州
陂	陂塘	陂陀
窨	窨井盖	窨井
獬	獬豸	
苋	苋菜	苋科
氟	氟利昂	氟化氢
窨	窨井盖	窨井
蝤	蝤蛑	
洇	洇湿	
迳	迳自	迳直
豉	豉汁	
陂	陂塘	陂陀
蚍	蚍蜉撼树	蚍蜉
蝤	蝤蛑	
枞	枞树	枞阳
砀	砀山	砀山县
钴	钴蓝	钴蓝色
枞	枞树	枞阳
邗	邗沟	邗江
箜	箜篌	
钡	钡餐	钡剂
螟	螟蛉	螟岭
蹁	蹁跹	
蛴	蛴螬	
锂	锂电池	锂离子
殚	殚精竭虑	殚精竭力
谥	谥号	
鳇	鳇鱼	
斫	斫轮老手	
啮	啮齿动物	啮齿
芗	芗城	芗城区
鹈	鹈鹕	
岬	岬角	
氅	氅衣	
泅	泅渡	泅水
腧	腧穴	
鳟	鳟鱼	
濠	濠江	濠梁之上
淖	淖尔	
汜	汜水镇	
钣	钣金件	
缦	缦杰	
岷	岷山	岷江
蘼	蘼芜	
囿	囿于	囿于成见
缙	缙云	缙云山
妗	妗子	
胼	胼手胝足	胼胝
硼	硼砂	硼酸
赭	赭红	赭红色
薜	薜荔	薜萝
篾	篾片	篾匠
蚰	蚰蜒	
蒺	蒺藜	
衾	衾影无惭	
滦	滦州	滦县
娈	娈童	娈童案
珙	珙桐	珙县
蘅	蘅塘退士	
僮	僮仆	僮族
踯	踯躅	
漳	漳州	漳河
秫	秫秸	秫米
鲅	鲅鱼	鲅鱼圈
砭	砭石	砭骨
秣	秣马	秣马厉兵
肽	肽键	肽链
缢	缢死	缢痕
阈	阈值	阈限
璩	璩美凤	
铨	铨叙	铨考
垩	垩粉	
趸	趸船	趸批
缟	缟素	缟衣
杲	杲杲	
藿	藿香	
烷	烷基化	烷基
濉	濉溪	濉溪县
摈	摈弃	摈除
疣	疣鼻天鹅	
滁	滁州	滁县
镪	镪水	
蕲	蕲春	蕲蛇
鲷	鲷鱼	
绶	绶带	绶带鸟
锱	锱铢必较	锱铢
杼	杼轴	
孀	孀居	孀妇
懋	懋功	懋勤殿
锰	锰钢	锰矿
酰	酰胺	酰胺键
郓	郓城	郓城县
橛	橛子	
尥	尥蹶子	
锆	锆石	
氖	氖气	氖灯
逶	逶迤	
疟	疟疾	疟原虫
疟	疟疾	疟原虫
酚	酚酞	酚醛
邛	邛海	邛崃
檩	檩子	檩条
铣	铣床	铣刀
庠	庠序	
涪	涪陵	涪城
伛	伛偻	
畿	畿辅	畿内
扦	扦插	扦子
畦	畦田	
沤	沤肥	
嫘	嫘祖	
诤	诤友	诤言
轸	轸念	
莴	莴笋	莴苣
彳	彳亍	
椋	椋鸟	
蚬	蚬壳	
抟	抟心壹志	
獭	獭兔	獭祭
黜	黜退	黜免
醪	醪糟	
枥	枥木县	
垓	垓下	
氦	氦气	
唿	唿哨	唿扇
菏	菏泽	菏泽市
馔	馔具	
狎	狎妓	狎侮
暹	暹罗	暹罗人
趺	趺坐	
猗	猗顿	
佶	佶屈聱牙	
榉	榉树	榉木
铰	铰链	铰接
醴	醴泉	醴陵
衽	衽革枕戈	
铵	铵盐	
鲥	鲥鱼	
夥	夥伴	
柞	柞树	柞木
昝	昝云龙	
柞	柞树	柞木
啁	啁啾	
榫	榫卯	榫头
伉	伉俪	伉俪情深
檑	檑木	
訾	訾议	
攮	攮子	
驽	驽钝	驽马
蓖	蓖麻	蓖麻子
盱	盱眙	盱衡厉色
淝	淝河	
糨	糨糊	糨子
郏	郏县	
悭	悭吝	
鸬	鸬鹚	
穰	穰穰满家	
椴	椴木	椴树
辎	辎重	
陟	陟降	陟罚臧否
仵	仵作	仵官
髀	髀肉复生	髀里肉生
跬	跬步	跬步千里
喹	喹诺酮	喹啉
苄	苄基	
隰	隰县	
溴	溴化物	溴化锂
氩	氩弧焊	氩气
鄞	鄞县	鄞州区
芨	芨芨草	
砻	砻谷	砻糠
楝	楝树	
呖	呖呖	
砬	砬子	
蓍	蓍草	蓍龟
錾	錾子	
酯	酯化	酯交换
擢	擢升	擢用
锺	锺子期	
旃	旃檀	
茼	茼蒿	茼蒿菜
骠	骠骑	骠勇
庹	庹宗康	庹宗华
缂	缂丝	
骠	骠骑	骠勇
榧	榧子	
怫	怫然不悦	怫然作色
痈	痈疽	痈肿
疥	疥疮	疥癣之疾
蛏	蛏子	蛏干
戕	戕害	戕贼
桡	桡骨	桡动脉
耦	耦合	耦联
疝	疝气	
坩	坩埚	坩锅
桄	桄榔	
磙	磙子	
螽	螽斯	螽斯衍庆
傩	傩神	傩戏
鲇	鲇鱼	
蓊	蓊蓊郁郁	蓊郁
飨	飨客	飨宴
髌	髌骨	
揆	揆情度理	揆时度势
溘	溘然而逝	溘然长逝
僖	僖宗	
檄	檄文	檄书
鲱	鲱鱼	
呋	呋喃	呋喃丹
徭	徭役	
掎	掎角之势	掎裳连襼
镢	镢头	
疱	疱疹	疱疹病毒
熘	熘鱼片	熘肝尖
溧	溧水	溧阳
澧	澧水	澧县
鞣	鞣制	鞣酸
褡	褡裢	褡包
圪	圪塔	圪节
舢	舢板	
矸	矸石	
骈	骈文	骈四俪六
畚	畚斗	畚箕
眄	眄视指使	
螨	螨虫	
钽	钽电容	
霪	霪雨	
纡	纡回	纡尊降贵
鳙	鳙鱼	
剡	剡溪	
疖	疖子	
狷	狷介之士	
赍	赍志而没	
茭	茭白	
鸱	鸱尾	鸱吻
牝	牝马	牝鸡
砗	砗磲	
愆	愆期	愆尤
遴	遴选	遴选出
螫	螫人	螫毒
诰	诰命	诰封
剡	剡溪	
潲	潲水	潲雨
笊	笊篱	
潴	潴留	潴龙河
瘢	瘢痕	
鳔	鳔胶	
篦	篦子	篦麻
嘧	嘧啶	
拊	拊心泣血	拊膺顿足
锑	锑矿	
揠	揠苗助长	
龃	龃龉	龃齿
郫	郫县	
侪	侪辈	
茌	茌平县	茌平
阒	阒无一人	阒寂
挈	挈瓶之知	
龋	龋齿	
镏	镏金	镏子
荦	荦荦大者	荦荦大端
儋	儋州	儋州市
畲	畲族	
菽	菽粟	菽麦
脲	脲醛树脂	
嗉	嗉囊	嗉子
橐	橐驼	
栲	栲栳	栲胶
呒	呒啥	
颟	颟顸	颟顸无能
缬	缬氨酸	缬草
阋	阋墙	
硒	硒鼓	
讣	讣告	讣闻
鲂	鲂鱼赪尾	
郯	郯城	郯城县
矾	矾石	矾土
鲳	鲳鱼	
踔	踔绝之能	踔厉风发
莼	莼菜	莼鲈之思
钤	钤记	钤印
炔	炔诺酮	炔雌醚
鏊	鏊子	
鲮	鲮鱼	鲮鲤
痤	痤疮	
嵯	嵯峨	
腠	腠理	
骖	骖鸾驭鹤	
黩	黩武	黩武穷兵
碓	碓房	
痼	痼疾	痼癖
绀	绀青	
鹳	鹳雀楼	鹳雀
糌	糌粑	
觳	觳觫	
黧	黧黑	
秭	秭归	秭归县
瘿	瘿瘤	
髋	髋部	髋骨
鳊	鳊鱼	
沔	沔阳	沔阳县
岘	岘港	
崤	崤函之固	
硖	硖石	
仡	仡佬	仡佬族
铱	铱金	铱金笔
蚜	蚜虫	
芫	芫荽	芫花
壅	壅塞	壅蔽
鄄	鄄城	鄄城县
嘌	嘌呤	
惝	惝恍	惝恍迷离
愀	愀然变色	愀然不乐
骶	骶骨	骶椎
酢	酢浆草	酢酱草
蹀	蹀躞	
仡	仡佬	仡佬族
炻	炻器	
嬗	嬗变	
酢	酢浆草	酢酱草
孳	孳生	孳息
蟪	蟪蛄	
帏	帏幕	
馓	馓子	
颞	颞叶	颞骨
暌	暌违	
锔	锔锅匠	
蛞	蛞蝓	
蠓	蠓虫	
醯	醯胺	
囟	囟门	
羰	羰基	
挹	挹注	挹娄
狺	狺狺狂吠	
悒	悒郁	悒悒
苣	苣荬菜	
邳	邳县	邳州
俳	俳句	俳优
柽	柽柳	
褫	褫夺	褫夺公权
揿	揿下	揿住
苘	苘麻	
苣	苣荬菜	
瘘	瘘管	
傈	傈僳族	傈僳
髑	髑髅	
氘	氘核	
嵊	嵊县	嵊州
臌	臌胀	
栝	栝楼	
芟	芟除	芟夷
怙	怙恶不悛	怙恃
跖	跖骨	
畹	畹町	
铙	铙钹	
筚	筚路蓝缕	筚篥
艨	艨艟	
仫	仫佬族	仫佬
侔	侔色揣称	
钼	钼钢	钼矿
黾	黾勉	
籼	籼米	籼稻
饧	饧糖	
蜩	蜩螗沸羹	
漯	漯河	漯河市
粳	粳米	粳稻
鲣	鲣鱼	鲣鸟
跏	跏趺	
鹣	鹣鲽情深	
蛱	蛱蝶	
苤	苤蓝	
羟	羟色胺	羟基
袷	袷袢	
聱	聱牙诘屈	聱牙
锕	锕系元素	
漯	漯河	漯河市
凼	凼仔岛	
绲	绲边	
撙	撙节	
舴	舴艋	
槲	槲栎	槲寄生
髭	髭须	髭毛
舳	舳舻	舳舻相继
苎	苎麻根	苎麻
羧	羧基	羧酸
桫	桫椤	桫椤树
哌	哌啶	哌嗪
旰	旰食宵衣	旰食
蜣	蜣螂	
邴	邴元真	
箅	箅子	
鹁	鹁鸪	鹁鸽
悃	悃愊无华	
舾	舾装	
艴	艴然不悦	
梃	梃击案	
枋	枋湖	枋头
烃	烃类	
滏	滏阳	
鬻	鬻文为生	鬻儿卖女
阏	阏氏	
燠	燠热	
蕺	蕺菜	
冁	冁然而笑	
樗	樗蒲	樗栎庸材
裒	裒多益寡	
髂	髂骨	
桤	桤木	
瘰	瘰疬	
癃	癃闭	
辚	辚辚	
鹩	鹩哥	
溽	溽热	溽暑
稂	稂莠不齐	
莪	莪术	
谠	谠论侃侃	
箪	箪瓢屡空	箪食瓢饮
羝	羝羊触藩	
疳	疳积	疳疮
筲	筲箕	
虼	虼蚤	
澉	澉浦	澉浦镇
蒴	蒴果	
瘊	瘊子	
蚶	蚶子	蚶田
砟	砟子	
胬	胬肉	
酞	酞菁	
趑	趑趄	趑趄不前
膂	膂力	膂力过人
傧	傧相	
岢	岢岚	
杓	杓子	
秕	秕糠	秕子
菝	菝葜	
芤	芤脉	
跣	跣足	
垡	垡头	
桴	桴鼓相应	
瘗	瘗玉埋香	
饫	饫甘餍肥	
夤	夤夜	夤缘
峄	峄城区	峄城
郧	郧阳	郧西
饔	饔飧不继	饔飧不济
踺	踺子	
腈	腈纶	
氆	氆氇	
筢	筢子	
笸	笸箩	笸篮
耪	耪地	
汊	汊港	汊流
茺	茺蔚子	
筇	筇竹	
鸲	鸲鹆	
劬	劬劳	
佥	佥都御史	
缧	缧绁	
鸸	鸸鹋	
裣	裣衽	
蝾	蝾螈	
杓	杓子	
畛	畛域	
缫	缫丝	缫丝厂
蛲	蛲虫	
怃	怃然	
