并不	bb$
不错	bc$
不得	bd$
办法	bf$
不过	bg$
保护	bh$
不仅	bj$
不肯	bk$
本来	bl$
部门	bm$
半年	bn$
不怕	bp$
并且	bq$
别人	br$
表示	bs$
不同	bt$
把握	bw$
必须	bx$
不要	by$
不住	bz$
出版	cb$
常常	cc$
程度	cd$
充分	cf$
成功	cg$
窗户	ch$
参加	cj$
此刻	ck$
出来	cl$
充满	cm$
才能	cn$
产品	cp$
采取	cq$
承认	cr$
此时	cs$
传统	ct$
成为	cw$
出现	cx$
产业	cy$
存在	cz$
代表	db$
调查	dc$
得到	dd$
地方	df$
大哥	dg$
的话	dh$
大家	dj$
打开	dk$
带来	dl$
多么	dm$
大批	dp$
地区	dq$
当然	dr$
但是	ds$
点头	dt$
第二	dn$
单位	dw$
东西	dx$
第一	dy$
弟子	dz$
分别	fb$
非常	fc$
反对	fd$
方法	ff$
法国	fg$
发挥	fh$
房间	fj$
放开	fk$
法律	fl$
方面	fm$
分配	fp$
父亲	fq$
夫人	fr$
发生	fs$
反弹	ft$
反而	fn$
服务	fw$
发现	fx$
反应	fy$
发展	fz$
根本	gb$
工程	gc$
感到	gd$
功夫	gf$
改革	gg$
规划	gh$
感觉	gj$
公开	gk$
管理	gl$
革命	gm$
姑娘	gn$
公平	gp$
过去	gq$
果然	gr$
告诉	gs$
共同	gt$
各位	gw$
关系	gx$
关于	gy$
工作	gz$
毫不	hb$
何处	hc$
活动	hd$
恢复	hf$
回归	hg$
缓缓	hh$
环境	hj$
很快	hk$
回来	hl$
后面	hm$
害怕	hp$
回去	hq$
忽然	hr$
还是	hs$
回头	ht$
黑暗	hn$
毫无	hw$
或许	hx$
还有	hy$
孩子	hz$
基本	jb$
基础	jc$
觉得	jd$
解放	jf$
结果	jg$
几乎	jh$
经济	jj$
加快	jk$
建立	jl$
见面	jm$
今年	jn$
金牌	jp$
加强	jq$
进入	jr$
建设	js$
今天	jt$
极为	jw$
进行	jx$
教育	jy$
记者	jz$
恐怖	kb$
看出	kc$
看到	kd$
开发	kf$
客观	kg$
客户	kh$
看见	kj$
看看	kk$
看来	kl$
开门	km$
可能	kn$
恐怕	kp$
口气	kq$
客人	kr$
开始	ks$
客厅	kt$
渴望	kw$
科学	kx$
可以	ky$
控制	kz$
老板	lb$
露出	lc$
领导	ld$
浪费	lf$
两国	lg$
厉害	lh$
立即	lj$
离开	lk$
理论	ll$
里面	lm$
理念	ln$
老婆	lp$
离去	lq$
老人	lr$
历史	ls$
老头	lt$
另外	lw$
冷笑	lx$
利用	ly$
来自	lz$
明白	mb$
名称	mc$
目的	md$
麻烦	mf$
美国	mg$
模糊	mh$
面积	mj$
门口	mk$
美丽	ml$
慢慢	mm$
美女	mn$
门派	mp$
目前	mq$
美人	mr$
马上	ms$
明天	mt$
门外	mw$
模型	mx$
没有	my$
名字	mz$
那边	nb$
农村	nc$
难道	nd$
能否	nf$
那个	ng$
女孩	nh$
年纪	nj$
难看	nk$
那里	nl$
你们	nm$
哪怕	np$
女人	nr$
那时	ns$
念头	nt$
那位	nw$
那些	nx$
那样	ny$
女子	nz$
旁边	pb$
平常	pc$
判断	pd$
佩服	pf$
屁股	pg$
破坏	ph$
平静	pj$
片刻	pk$
漂亮	pl$
拼命	pm$
偏偏	pp$
脾气	pq$
平日	pr$
平时	ps$
普通	pt$
平安	pn$
颇为	pw$
培训	px$
朋友	py$
批准	pz$
全部	qb$
清楚	qc$
取得	qd$
气氛	qf$
全国	qg$
前后	qh$
期间	qj$
情况	qk$
起来	ql$
前面	qm$
去年	qn$
强迫	qp$
轻轻	qq$
情人	qr$
其实	qs$
其他	qt$
千万	qw$
情形	qx$
企业	qy$
其中	qz$
日本	rb$
如此	rc$
人大	rd$
若非	rf$
如果	rg$
如何	rh$
人家	rj$
人口	rk$
人类	rl$
人民	rm$
人品	rp$
热情	rq$
仍然	rr$
认识	rs$
如同	rt$
然而	rn$
认为	rw$
人心	rx$
人员	ry$
日子	rz$
身边	sb$
市场	sc$
说道	sd$
十分	sf$
送给	sg$
时候	sh$
时间	sj$
时刻	sk$
上来	sl$
什么	sm$
水平	sp$
事情	sq$
虽然	sr$
身上	ss$
身体	st$
是啊	sn$
所谓	sw$
实现	sx$
所以	sy$
身子	sz$
特别	tb$
提出	tc$
听到	td$
头发	tf$
通过	tg$
谈话	th$
条件	tj$
痛苦	tk$
讨论	tl$
他们	tm$
头脑	tn$
谈判	tp$
提起	tq$
突然	tr$
同时	ts$
太太	tt$
台湾	tw$
天下	tx$
统一	ty$
同志	tz$
而且	nq$
偶尔	nn$
无比	wb$
完成	wc$
问道	wd$
无法	wf$
我国	wg$
文化	wh$
文件	wj$
我看	wk$
为了	wl$
我们	wm$
物品	wp$
完全	wq$
温柔	wr$
晚上	ws$
问题	wt$
我爱	wn$
微微	ww$
微笑	wx$
唯一	wy$
位置	wz$
宣布	xb$
形成	xc$
许多	xd$
幸福	xf$
香港	xg$
喜欢	xh$
小姐	xj$
胸口	xk$
下来	xl$
项目	xm$
新品	xp$
想起	xq$
显然	xr$
先生	xs$
系统	xt$
喜爱	xn$
希望	xw$
相信	xx$
需要	xy$
现在	xz$
一般	yb$
因此	yc$
一定	yd$
衣服	yf$
应该	yg$
以后	yh$
已经	yj$
一块	yk$
原来	yl$
一面	ym$
一旁	yp$
一切	yq$
依然	yr$
也是	ys$
摇头	yt$
因而	yn$
因为	yw$
一些	yx$
一样	yy$
一直	yz$
准备	zb$
支持	zc$
知道	zd$
政府	zf$
这个	zg$
之后	zh$
自己	zj$
召开	zk$
这里	zl$
怎么	zm$
只能	zn$
只怕	zp$
之前	zq$
自然	zr$
只是	zs$
总统	zt$
作为	zw$
这些	zx$
这样	zy$
正在	zz$
